== ALL OBJECTS ==
American Flag | effortless | this donut shop is america-certified. LAND OF THE FREEE BABY!!!!!!!! (Hidden in City)
Anchor | effortless | in the water (Hidden in Goiky)
Bacon | effortless | right next to a fire (Hidden in Snowy)
Barbecue Sauce | effortless | look behind gelatin's steakhouse, which for the sake of the game has NOT been remade into gelatin's shadeshouse
Basketball | effortless | seems like someone has been shooting some hoops (Hidden in City)
Bell | effortless | whats at the top? (Hidden in Goiky)
Big Nickel | effortless | he's so big i don't know how you wouldn't find him
Birthday Cake | effortless | happy birthday! (it isn't your birthday) [Hidden in Candyland]
Bomby | effortless | explode! (Hidden at Hotel)
Book | effortless | In the City - where would you be most likely to find an annoying know-it-all?
Boombox | effortless | [Hidden in the Yoyleland Realm]
Burrito | effortless | i've always had a soft spot for burritos (Hidden in Tropical Islands)
Bushy | effortless | haha, nice try! but you arent fooling anyone. (Hidden at Hotel)
Cactus | effortless | they thought they could blend in lol!!! (Hidden in Desert)
Camera | effortless | filmin and stuff (Hidden in City)
Cereal Box | effortless | bet you can't guess where this is oh wow this is so hard
Chalk | effortless | hmmmmm (Hidden in City)
Christmas Tree | effortless | Look near spawn- wait it's not even December WHO ON EARTH PUT UP THEIR CHRISTMAS TREE?!
Clock | effortless | tick... tock... tick... tock... ringalingalingaling (Hidden in Number Playground)
Cream Cookie | effortless | there is a very obvious way up at candyland
Diploma | effortless | congratulations you graduated high school now it's time for your life to turn to hell (Hidden in Classic Roblox)
Eight | effortless | on the top of a hill (Hidden in Number Playground)
Evil Leafy | effortless | look at that forest, lets go in! (Hidden in Goiky)
Eyes in the Dark | effortless | [Hidden in the Yoyleland Realm]
Fairy Floss | effortless | hmmm i wonder where this one is hmmmmmm
Fanny | effortless | she's somewhere awfully hot
Fifteen | effortless | LEAVE!!!! (Hidden in Floating Island)
Firey | effortless | you seriously need a hint for this?
First Aid Kit | effortless | i don't quite understand why they're at the warehouse of all places
Fish Monster | effortless | look on the beaches
Fishy | effortless | we're surrounding by fish, you know what that means? FISH!!!!!! (Hidden at Hotel)
Five | effortless | hanging out with three (Hidden in Number Playground)
Flower | effortless | look inside that house?
Flower Cake | effortless | OH MY FLOWER CAKE (Hidden in Floating Island)
Flower Jr. | effortless | she's admiring a masterpiece (Hidden in Floating Island)
Fries | effortless | i cant belive he managed to get his own resturant! (Hidden in City)
Fruit Cake | effortless | they're chilling near the hotel
Funny Plant | effortless | Have you accidentally killed a plant and want to revive it? Then why don't you set it on fire? And then freeze it? Let it grow on the sun? Or zap it? Make it a fancy dinner? Or feed it to a fish monster? Or push it off a cliff? Dance on it? Explode it? Vomit on it? Play with it underwater?
Gaty | effortless | wonder where she is being used for? (Hidden in Snowy)
Gelatin | effortless | tbh his resturant is much better then fries' (Hidden in City)
Golf Ball | effortless | sitting down is so nice (Hidden in Goiky)
Grassy | effortless | chillin in the grass (Hidden in Goiky)
Hand-Powered Recovery Center | effortless | [Hidden in the Yoyleland Realm]
Hot Cocoa | effortless | i tried hot cocoa a few months ago i didnt like it. man, these descriptions have devolved into just personal stories haven't they? (Hidden in Snowy)
Ice Cream | effortless | [Hidden in the Yoyleland Realm]
Ice Cube Jr. | effortless | [Hidden in the Yoyleland Realm]
Ice Woody | effortless | how did they combine the two? (Hidden in Snowy)
Icey | effortless | basically ice cube but a fine lady (Hidden in Snowy)
Jaiden | effortless | woof (Hidden in Hotel)
Knife | effortless | [Hidden in the Yoyleland Realm]
Leafy | effortless | trees are cool. (Hidden in Goiky)
Long Pencil | effortless | [Hidden in the Yoyleland Realm]
Lotus Flower | effortless | Placeholder description i'll probably forget to change it but it's funnier like this (Hidden in Jungle)
Marble Bottle | effortless | how joyous (Hidden in Hotel)
Marker | effortless | playin toss the dirt (Hidden at Hotel)
Match | effortless | the freesmart van noooo!! (Hidden in Factory)
Milli | effortless | bark (Hidden in Hotel)
Mortar | effortless | Ever watch Brick and Mortar? (Hidden in Jungle) (Made by ThirteenthJade)
Naily | effortless | dont touch that spike! (Hidden in Snowy)
Noodle Cup | effortless | I am truthfully in tears from this series of events that has caused this exquisite noodle cup to be thrown onto the ground without explicit realization.
Orange | effortless | [Hidden in the Yoyleland Realm]
PaintyBook | effortless | where i keep my masterpieces (Hidden in Tropical Islands)
Pillow | effortless | sleeping. (Hidden in Goiky)
Pin | effortless | guess what pin? you won a win token! (Hidden in Number Playground)
Pineapple | effortless | who lives in a pineapple under the sea? (Hidden in Fossil Falls)
Pistachio | effortless | it looks like a pear inside an egg (Hidden at Hotel)
PiÂ±ata | effortless | it's on a tree, that's basically all you need to know
Prince Circle | effortless | what did they do to him (Hidden in Tropical Islands)
Pumpkin | effortless | behind a tree (Hidden in Goiky)
Purple Girl with Wind Hair and Angry Eyes | effortless | best character in bfb moment (Hidden in Candyland)
RCTI Cast | effortless | aha yes i know what rcti is it's uhh uhhhhh ermmm uh uhhhh (Hidden at Warehouse)
Robot Teardrop | effortless | being manufactured at the factory
Rusty Coin | effortless | im broke, buy my stuff. (Hidden in Desert)
Sandcastle | effortless | playing in the sand (Hidden in Number Playground)
Saw | effortless | whats she doing cutting that tree? (Hidden in Snowy)
Scissors | effortless | not sure if you can really just cut a tree down like that (Hidden in Floating Island)
Selfie Dog | effortless | what do they like to do? (Hidden in Snowy)
Shopping Cart | effortless | shopping for stuff! (Hidden in City)
Snare Drum | effortless | touch them! (Hidden in Snowy)
Snowman | effortless | come to think of it... how do these snowmen not even melt? (Hidden in Snowy)
Sotp Sign | effortless | JUST STOP IT. (Hidden in City)
Stapy | effortless | hangin out with marker (Hidden at Hotel)
Strawberry | effortless | they're enjoying a nice feast (Hidden in Goiky)
Ten | effortless | jacknjelifys 1 million subscribers! (Hidden in Number Playground)
Tent | effortless | who gave the tent boxing gloves (Hidden in Classic Roblox)
Three | effortless | hanging out with five (Hidden in Number Playground)
Traffic Cone | effortless | these inanimate objects are getting out of hand (Hidden in City)
Tree | effortless | Im a tree, im a tree. (Hidden in Goiky)
Trombone | effortless | right above snare drum (Hidden in Snowy)
Vote | effortless | vote using the square brackets! [C] for Blob (Hidden at Factory)
Water Bottle | effortless | water bottle is here to save the day!! (Hidden at Hotel)
Woody | effortless | where you think he is. (Hidden in Snowy)
X the Arcade Machine | effortless | SPOOOOOKY arcade machine!!! just in time for halloween (Hidden in Warehouse)
Zero | effortless | next to ten
8 Inch Floppy Disk | easy | haha i didnt make it 8 inches what will you do about it (Hidden in Classic Roblox)
Announcer | easy | flying with his ufo! (Hidden in City)
Apple | easy | hey apple! KNIFE!!! oh and this is near spawn
Arron | easy | arron my beloved (Hidden in Classic Roblox)
Atom | easy | it's right there (Hidden in Number Playground)
Avocado | easy | blending in! (Hidden in City)
Baby | easy | WAHHHH!!! WAHHHH!!!!! I NEED MILK!!!!!!!!!!! (Hidden In City)
Bag of Sand | easy | [Hidden in the Barren Desert Realm]
Banana Apple | easy | sitting on a tree... (Hidden in Goiky)
Barry | easy | ourple (Hidden in Fossil Falls)
BF1D Carrot | easy | [Hidden in the BF1D Realm]
Birdhouse | easy | nature is epic.............. (Hidden at Hotel)
Blocky | easy | In an area he probably shouldn't be in. What a delinquent. (Start in Goiky)
Bow And Arrow | easy | [Hidden in the Barren Desert Realm]
Bozo | easy | hiding behind a vase (Hidden in City)
Car Door | easy | good thing you can't thlam your- (Hidden in City)
Cheese Orb | easy | [Hidden in the Barren Desert Realm]
Churro | easy | [Hidden in the Barren Desert Realm]
Clown Car | easy | go ahead, get in the clown car, you know it suits you (Hidden at Warehouse)
Club | easy | (Hidden in Factory)
Conch Shell | easy | for someone in the desert area, they look pretty rad
Cookie | easy | hidden in profiley's room, maybe because they store profiley's passwords. get it?
Crayon | easy | on a piece of paper (Hidden in Number Playground)
Curly Arrow | easy | [Hidden in the Barren Desert Realm]
Dane | easy | hey (Hidden in City)
Dime | easy | golf ball dropped her dime (Hidden in Goiky)
Discy | easy | perhaps it's a disc to a game?
Donut | easy | being served as food... wuh oh (Hidden in City)
Euro | easy | how much will it cost? not even a euro. (Hidden in Fossil Falls)
Evil Marker | easy | he doesn't want to play toss the dirt anymore (Hidden in Floating Island)
Fire Citrus | easy | HOT HOT HOT!!! (Hidden in Jungle)
Fish | easy | blub blub blub (Hidden in Classic Roblox)
Fork Repellenty | easy | dropped on the floor (Hidden in Factory)
Grape | easy | [Hidden in Yoyleland]
Greeny | easy | ball 2: the sequel (Hidden in Warehouse)
Hole in the Wall | easy | look for, well, a hole in the wall
Jetpacky | easy | In what situation could you POSSIBLY need a jetpack in a Warehouse for? This is the actual hint (Made by DrPepperHeinz)
Konpeito Jar | easy | excuse me, a what jar?? (Hidden in City)
Lamp Post | easy | "i'm seeing double!" that was  their last word (Hidden in City)
Lewis | easy | [Hidden in the Yoyleland Realm]
Lightning Cherry | easy | hidden on a board
Limbless Pin | easy | How did she manage to get on there without limbs? (Hidden in Floating Island)
Lollipop Plush | easy | [Hidden in the Yoyleland Realm]
Loser | easy | sitting in his throne. (Hidden in City)
Magic Conch | easy | [Hidden in the Barren Desert Realm]
Magician Hat | easy | everyone knows the famous spell, "yaba daba doo" (Hidden in Classic Roblox)
Mochi | easy | mochji (Hidden in City)
Needle | easy | needle in a haystack, how original (Hidden in Goiky)
Nickel | easy | on the ground somewhere.
Ninja Woody | easy | The suspiciously Woody shaped hole:
Orb | easy | floating orb, floating island
Ornament | easy | it's an ornament, yep. sorry i dont really have anyrthing to say (Hidden in Snowy)
Pandora Book | easy | [Hidden in the Yoyleland Realm]
Pearl | easy | look inside of a clump of cotton candy
Pickle Juice | easy | they really just need a moment to rethink their lifefe decisions (Hidden in Tropical Islands)
Piney | easy | what do you think pinecones are on?
Popcorn | easy | give me some of that popcorn (Hidden in Hotel)
Postcard | easy | [Hidden in the BF1D Realm]
Profiley | easy | pictures be like (Start in Goiky)
Ring | easy | [Hidden in the BF1D Realm]
Roboty | easy | my brain keeps "resetting"
Ropey | easy | they're such a silly slithering little rope (Hidden in Goiky)
Rose | easy | bumblebees are out! (Hidden in City)
Rubber Spatula | easy | being sad at the death of a group. (Hidden in Goiky)
Sand | easy | behind something in the sand
Sand Clock | easy | [Hidden in the Barren Desert Realm]
Sandwich Roll | easy | on top of a giant plant (Hidden in Jungle)
SaulStories | easy | My Name is Saul and THese Are My Sttories. Watch Evan the Wolf! (Made by Meowbah)
Screen Door | easy | look inside the warehouse
Spongy | easy | sitting on the plane! (Hidden in Tropical Islands)
Spunce | easy | what is this thing even supposed to be? (Hidden at Hotel)
Stickman | easy | [Hidden in the BF1D Realm]
Stocking | easy | [Hidden in the BF1D Realm]
Sun Spray | easy | in an area where you need it most (not tropical islands though)
Swappy | easy | [Hidden in the Yoyleland Realm]
Swing | easy | does this even remotely resemble a swing?? (Hidden in Classic Roblox)
Tape | easy | they're in a "sticky" situation! im not funny (Hidden in City)
Teardrop | easy | something water perhaps.
Tophat | easy | very fancy (Hidden at Factory)
TV | easy | hiding under a flight of stairs
UFO | easy | did you know the population of jupiter is 60,802 (Hidden in Factory)
Unpainted Gaty | easy | [Hidden in the Yoyleland Realm]
Wish | easy | get up there and make a wish! (Hidden in City)
Xmas Light | easy | (Hidden in Fossil Falls)
a | moderate | aaaaaaaa (Hidden in Desert)
A Duck | moderate | who doesnt play with them in the bath? (Hidden in Goiky)
A Tree | moderate | [Hidden in the Yoyleland Realm]
Acacia Tree | moderate | literally stuck in a tree (Hidden in Number Playground)
Awesome Diamond | moderate | The more easy objects I add, the easier it gets to reach the 1000 medal, right? This is an actual hint btw
Barf Bag | moderate | Contemplating life: multifaceted in many ways yet following a pattern. Amidst a wave of ingenuity, compassion, creativity, and an ever increasing population of souls destined to part from this mortal plane or live on forever as memories. Life can best be defined as a dance of ideals and limitations. Nobody is perfect; neither you or me or ANYONE in this whole planet can call themselves flawless. While we may fight for our beliefs, it is important to remember that we all share the same basic components and should respect the beliefs of others instead of fighting because of them. Why barf bag of all objects to contain such a description like this? I don't know, I just felt like it. Expect more of these in the future I guess. Since you read all of this, Barf Bag is located on one of the museum's pillars. You'll need to get on top of the Library to reach. (Hidden in City)
Beanie | moderate | look inside of a bush (Hidden in Jungle)
Bermuda | moderate | make sure you don't get sucked in by them (Start in Classic Roblox) (Made by AccountDoesNothing)
Bowl of Petunias | moderate | mmmmm... delicious... you ever just eat a bowl of flowers (Hidden in Tropical Islands)
Canadian Flag | moderate | it still looks better than the canadian flag in r/place (Hidden in Classic Roblox)
Carrot | moderate | CARROT!!! (Hidden in Warehouse)
Carrot Cake | moderate | [Hidden in the Yoyleland Realm]
Charcoal | moderate | in a place full of fire and heat (Hidden in Snowy)
Cheesy Mayo | moderate | it's mayo... but CHEESY OOOokay so now it makes sense why they are right next to a dumpster (Hidden in City)
Chicken Nugget | moderate | do you want free chicken nuggets (Hidden in Classic Roblox. Start at Hotel.)
Choo Choo The Train | moderate | [Hidden in the Yoyleland Realm]
Clip | moderate | clipped onto a frame (Hidden in Desert)
Cloudy | moderate | Jump on a few platforms (Hidden in Goiky)
Coiny | moderate | the opposite of where nickel was (Hidden in Goiky)
Compass | moderate | Id suggest checking paper, but who knows lol
Computer Mouse | moderate | this one is actually not where you'd expect it to be (Hidden in Classic Roblox)
Cotton Candy | moderate | those are some nice looking cotton candy trees
Cranberry | moderate | i dont like cranberry (Hidden in Hotel)
Crazy Needle | moderate | At the end of the rainbow.
Crumbley | moderate | nice roof (Hidden in Factory)
Dreartop | moderate | [Hidden in the Yoyleland Realm]
Dreidel | moderate | they go spin (Hidden in Warehouse)
Duffel Bag | moderate | yeah (Hidden in Fossil Falls)
Electric Guitar | moderate | ah yes the void (Hidden in Floating Island)
Eraser | moderate | he's still climbing that string (Start in Goiky)
Ethernet Splitter | moderate | he's an ethernet splitter while this game is your internet splitter! (Hidden in Factory)
Fall Leafy | moderate | find a way up a tree (Hidden at Hotel)
Firey Plush | moderate | totally not hiding behind a cactus
Foldy | moderate | oh god shes falling! (Hidden at Hotel)
Football Player | moderate | somebody left their helmet somewhere
Four Plush | moderate | why wont people buy him?? (Hidden in City)
Glue | moderate | why would you handstand in glue??? (Hidden in Desert)
Hammer | moderate | do you think the person who invented hammers was eating a ham sandwich at the time? sorry just trying to make a bad joke (Hidden at Hotel)
Happy Birthday Card | moderate | it still isn't your birthday (Hidden in Snowy)
Hot Chocolate | moderate | obviously someone would want this during the cold
Hot Dog | moderate | hidden besides a structure (Hidden at Warehouse)
Isabella | moderate | i don't get it... it's just a purple ball (Hidden in Classic Roblox)
Jacknjellify | moderate | WHAT (Hidden in Floating Island)
Jordan | moderate | inside a restaurant, hmm i wonder which one...
Keytar | moderate | rock away little keyboard guy!!!! (Hidden in Classic Roblox)
King Pen | moderate | you were probably expecting me to make king pen one of the hardest objects in the game, but no all you get is a normal difficulty (Hidden in City)
Kitchen Sink | moderate | look for some bathroom stalls, which is weird since they are a kitchen sink
Leafy Plush | moderate | someone lost their plushie at home
Leek | moderate | behind a tree (Hidden in Floating Island)
Metal Ball | moderate | [Hidden in the Yoyleland Realm]
Microphone | moderate | mic up (Hidden in Warehouse)
Modern Art | moderate | this and lollipop's scribble are pieces of art (Hidden in Hotel)
Mr. Fish | moderate | fishes... fisHES... FISHESS!!
One | moderate | most forgettable number in bfb. i am writing this two years later to say that this didn't age well (Hidden in Number Playground)
Paint Palette | moderate | it's in something pink..
Pen | moderate | on a table, being used as a regular item.
Pencil | moderate | find a paper on the ground and click on it.
Price Tag | moderate | the roofy roof was a cool roof.
Puppet | moderate | behind a door somewhere
Puzzle Piece | moderate | on a table or a shelf...
Rainbow | moderate | check on the rainbow at floating island
Rainbow Puppy | moderate | yay puppeee (Hidden in Floating Island)
RoboBoi | moderate | put on these glasses, and you'll ent- hey wait didn't i already make that joke? (Hidden in Hotel)
Runner Up | moderate | [Hidden in the Yoyleland Realm]
Rutabaga | moderate | (Hidden in Classic Roblox)
Salt Lamp | moderate | salti lampi (Start in Goiky)
Science Book | moderate | wall wraparound moment (Hidden in Floating Island)
Shuriken | moderate | i'm a ninja!! (Hidden in Jungle)
Smokebox | moderate | Click a suspicious button in a place that sells food.
Sock | moderate | all alone under the bed (Hidden in Floating Island)
Space Book | moderate | haha i have no idea what to put here (Hidden at Hotel)
Spray Bottle | moderate | (Start in City)
Steamy | moderate | oh no, a cloudy ripoff!! (Hidden in Goiky)
Sticker | moderate | you'll never be able to beat this one!!! ruahahahahahahaha!!!!!!!!!!!! (Start in Desert) (Made by 0OFunkyPurple)
Sugar Cube | moderate | well, there's only one way on that lollipop
Taco | moderate | reference to bfb 29 (Hidden in Goiky)
Toilet Paper | moderate | they will not know the trauma of being used (Hidden in Number Playground)
VHSy | moderate | go back to the 80's where you belong! (Hidden in City)
Vibe Check X | moderate | looks like you're going to the E.X.I.T. realm jimbo (Hidden in Snowy)
Waffle | moderate | todays menu! waffle..? (Hidden in City)
Wallet | moderate | gee, sure hope no one will steal this wallet in the headquarters! (Hidden in City)
Watermelon Slice | moderate | tree climbing simulator (Hidden in Fossil Falls)
Winner | moderate | somewhere near loser where i wont tell
Yo-Yo | moderate | right next to a mouse hole (Hidden in Factory)
Zipper | moderate | they're so little (Hidden in Classic Roblox)
8-Ball | normal | What is the thing on his head? (say in chat)
9-Ball | normal | near their twin
Aloe Vera | normal | [Hidden in the Yoyleland Realm]
Amethysty | normal | cool, i guess (Hidden in Tropical Islands)
Awesome Face | normal | not quite epic, but still awesome (Hidden in Jungle)
Bababa | normal | [Hidden in Magma Canyon realm]
Baking Soda | normal | how tasty (Made by lowk3y_TJ) (Start in Warehouse)
Ball | normal | looks they got bounced up too high... they landed straight onto a tree! (Hidden in Number Playground)
Balloony | normal | try jumping off of a high building to it (Hidden in City)
Bally | normal | every sport needs a ball! i don't think this is the right type
BFDI Marker | normal | funny how this is the 3rd marker-related object in the game (Hidden in Classic Roblox)
Bitty | normal | what is an area that's very retro-like?
Blender | normal | click a poster that totally isnt about a blender
Block Party | normal | [Hidden in Magma Canyon realm]
Blue Gelatin | normal | [Hidden in the Yoyleland Realm]
Bottle | normal | yoo check out that big R! (Hidden in City)
Bracelety | normal | watching ice cube is fun. (Hidden in Snowy)
Brownie | normal | [Hidden in the Yoyleland Realm]
Butter | normal | This is Butter. From This game. (Hidden in City)
Buzzsaw | normal | It's everyone's favourite object, Bu- hey wait... what are they doing here?! (Hidden in Factory, made by
Can of Black Olives | normal | [Hidden in the Barren Desert Realm]
Car Engine | normal | vroom (Hidden in City)
Cardboard | normal | [Hidden in the Barren Desert Realm]
Cave Drawing | normal | a drawing to be forgotten (Hidden in Factory)
cheese | normal | i should have never put custom avatars into the ultra mega fart donation perks (this is a repeat of fredster's description) (Start in Warehouse)
Cheese Slice | normal | [Hidden in the Barren Desert Realm]
Chestnut | normal | (Hidden in Fossil Falls)
Chocolate Bar | normal | i'll let you figure this one out on your own
Clover | normal | sticking out of a bush [Hidden at Warehouse]
Cologne | normal | think about it, where are you gonna go when you need to find cologne?
Cookie Pizza | normal | ... maybe it's a good thing they're hidden... (Hidden in Classic Roblox)
Dark Gemstone | normal | chilling at the peak of the fossil falls (Made by 3RR0R_B0I)
Domino | normal | in the yellow face warehouse
Drinky Bird | normal | Hidden in City
Ellipsis | normal | [Hidden in the Barren Desert Realm]
Fettuccine | normal | the first floating island update in one million years (Hidden in Floating Island) (Made by lowk3y_TJ)
Firey Jr. | normal | in fire?
Firey Jr. Jr. | normal | [Hidden in the Barren Desert Realm]
Flag | normal | [Hidden in the BF1D Realm]
Fourteen | normal | they're a little silly (Hidden in Number Playground)
gas can | normal | [Hidden in Magma Canyon realm]
Green Egg | normal | look inside of the jungle
Hazelnut | normal | [Hidden in the Barren Desert Realm]
Hexagon | normal | if only hexagon was invented in latin (Hidden in Jungle)
Johnson | normal | [Hidden in the Barren Desert Realm]
Kabab | normal | look beneath fries' table (Hidden in City)
Leaf | normal | [Hidden in the BF1D Realm]
Lemonade | normal | this lemonade is minging (Hidden in Desert)
Lightning | normal | up in the sky (Hidden in Goiky)
Lollipop | normal | that lollipop is tasty!
Meat Cube | normal | wall flicking, how fun! (Hidden in Warehouse)
Metal Scrap | normal | more like uhh... metal CRAP. i am a little #edgy (Made by FunkyPurple) (Start in Floating Island)
Milkshake | normal | (Start  in Candyland)
Nine and Six Combined | normal | jacknjellify knew exactly what they were doing (Hidden in Number Playground)
Pasty | normal | is this supposed to be pasta (Hidden in Jungle)
Plump Dog | normal | plump th dog (Hidden in Desert)
Pop Tart | normal | just being a pop tart (Start in Candyland)  (Made by cluxser2)
Purple Dragon | normal | that foolish dragon (Hidden in Fossil Falls... you can almost definitely see it.)
Robot Flower | normal | behind something, i aint telling you what. (Hidden in Factory)
Robot Woody | normal | [Hidden in the Barren Desert Realm]
Rocky | normal | Can someone PLEASE help him get out!? He's being a pest. (Hidden in City)
Ruby | normal | check inside the factory area
S'mores Milkshake | normal | smores are yummy and milkshakes are yummy, so why not? (Hidden in Classic Roblox)
Seaweed | normal | find a group of seaweed on the corners of the map (Made by Ohlegess)
Slug | normal | MAKE IT STOP (Hidden in Desert)
Snake | normal | be careful of the lurking jungle snakes
Spongy's Mother | normal | [Hidden in Magma Canyon realm]
Stop Light | normal | [Hidden in the Yoyleland Realm]
Taco Guy | normal | it's not taco, it's taco guy, get it right (Hidden in Jungle)
Triangle | normal | why are they so mad what went wrong (Hidden in Classic Roblox)
Turkey | normal | [Hidden in Magma Canyon]
USB | normal | look behind a tree, not just any tree though (Hidden in City)
V | normal | ectored (Hidden in Number Playground)
Wicker Basket | normal | [Hidden in the Barren Desert Realm]
Banana | intermediate | same deal as pasty (Hidden in Jungle)
Bird | intermediate | hoot hoot tweet tweet (Hidden in Classic Roblox)
Blanket | intermediate | they going zzzzzzzz (Hidden in Goiky)
Blue Lion | intermediate | first yellow leopard, then red elephant, and now THIS? (Hidden in Floating Island)
Blue Shiny Coiny | intermediate | i've got my own style! (Start in Goiky)
Boom Mic | intermediate | (Start  in Candyland)
Bready | intermediate | me when the uhhh errr uhhh ummm bread (Hidden in City)
Cartridge | intermediate | find a cave
Chainsaw | intermediate | [Hidden in the Cherry Grove Realm]
Chanterelle | intermediate | ah yes the void (Hidden in Floating Island)
Cheddary | intermediate | [Hidden in the Cherry Grove Realm]
Chef David | intermediate | aw seriously? another david? (Hidden in Candyland)
Cherry Blossom | intermediate | [Hidden in the Cherry Grove Realm]
Clay | intermediate | [Hidden in the Backrooms]
Computer | intermediate | [Hidden in the Backrooms]
Crate | intermediate | what else is there that contains items? (Hidden in Desert)
David | intermediate | noclip into something unexpected
Davidworm | intermediate | i wish i lived in a timeline where this didnt exist (Hidden at Hotel)
Dollar Bill | intermediate | look inside of a bush (Hidden at Warehouse)
Fish Cracker | intermediate | [Hidden in the Yoyleland Realm]
Flower Crown | intermediate | i don't know what to make the description, but to be fair i never do (Hidden in Jungle)
Fortune Cookie | intermediate | someone dropped them on the floor (Hidden in City)
Four and X | intermediate | it isn't a badge hunt game without a cliche teamwork one (Hidden in Number Playground)
Genderfluid Book | intermediate | should have made this during pride month darn (Hidden in City)
Good Rhombicosidodecahedron | intermediate | he wants to be just like his father! [start in warehouse]
Green Rocky | intermediate | green rocky!!! do the thing!!! HOW COULD THIS HAPPEN?!?!? (Hidden in Jungle)
Guava | intermediate | [Hidden in the Cherry Grove Realm]
Idoit | intermediate | idoit will never be forgotten (Hidden in Goiky)
Knifeball | intermediate | they give out terrible advice alphabetically (Hidden in Warehouse)
Lantern | intermediate | [Hidden in the Cherry Grove Realm]
Lasery | intermediate | [Hidden in the Yoyleland Realm]
Lever | intermediate | complete an obby at the factory
Lip Gloss | intermediate | check behind vases (Hidden in Hotel)
Mail | intermediate | you've got mail (Hidden in Classic Roblox)
Meteor | intermediate | OH GOD WE'RE ALL GOING TO DIE!!!!!!!!!!!!! (Hidden in Classic Roblox)
Miku | intermediate | klaptai would be proud
Milli Book | intermediate |  (Start in Candyland)
Paragraph | intermediate | [Hidden in the Yoyleland Realm]
Pea | intermediate | did you eat your peas today (Hidden in Classic Roblox)
Pear Tree | intermediate | [Hidden in Classic Paradise]
Pixelated Heart | intermediate | i wonder what that heart is doing (Hidden at Hotel)
Remote | intermediate | that remote looks cool.
Ringy | intermediate | [Hidden in the Backrooms]
Sand Jar | intermediate | they definitely hate mondays (Hidden in Desert)
SD Card | intermediate | find an invisible path near planks of wood (Hidden at Factory)
Seven | intermediate | not what you think it is... (Hidden in Number Playground... or is it?)
Six | intermediate | they're alone in the sky (Start in Goiky)
Sketchpad | intermediate | [Hidden in the Yoyleland Realm]
Spoony | intermediate | why would you use them anyway? (Hidden in City)
Star Coin | intermediate | [Hidden in the Cherry Grove Realm]
Succulent | intermediate | THIS IS NOT HOW GRAVITY WORKS I THINK (Hidden in Floating Island)
Symbol | intermediate | this is the symbol of crying because you have to do spongezilla legit
Tabley | intermediate | Get up the difficulty chart.
Texas Donut | intermediate | something is off about where succulent is... (Hidden in Floating Island)
Violet | intermediate | In the greenhouse, with all of her siblings!
Well | intermediate | oh well (Hidden in Tropical Islands)
Yoylelite | intermediate | [Hidden in the Yoyleland Realm]
Air | hard | everyone give a round of applause to our 5th nonexisty (Hidden at Hotel)
Among Us X | hard | HI GELATIN (Start in City)
Bacon Bit | hard | [Hidden in the Barren Desert Realm]
Barf Molecule | hard | look in the city... something yellow
Beehive | hard | [Hidden in the Yoyleland Realm]
BF1D Ball | hard | [Hidden in the BF1D Realm]
Blob | hard | you need to vote for them, but how?
Bonsai | hard | [Hidden in Sakura Serenity]
Bowling Ball | hard | look inside seven's quiz room
Bright Radiant Plasma Needle | hard | Needle Family Reunion!
Broccoli | hard | [Hidden in Classic Paradise]
Bugspray | hard | [Hidden in Sakura Serenity]
Buzzer | hard | [Hidden in Classic Paradise]
Calculator | hard | i hope you're good at square root
Candy | hard | somewhere with a lot of candy
Candy Corn | hard | i am the ONLY ONE who actually likes candy corn???? (Start in Candyland)
Cary | hard | NO WAY IT'S CARY HIMSELF!!! (Hidden in Classic Roblox)
Cat | hard | taking stuck on a tree to the next level (Start in City)
Chocolate Chip | hard | find a code at candyland
Chocolate Pop | hard | this is literally just cake pop 2 (Hidden in Candyland)
Coffee Bean | hard | (Hidden in Fossil Falls)
Container | hard | [Hidden in Classic Paradise]
Cupcake | hard | [Hidden in Midnight Rooftops Realm]
Cursor | hard | [Hidden in Midnight Rooftops Realm]
Diskette | hard | gotta risk it for the diskette (Hidden in Factory)
Dragon Scale | hard | [Hidden in the Yoyleland Realm]
Eggy | hard | behind a shelf in the city
English Cream Cake | hard | on top of a fridge somewhere (Start in City)
Fire Melon | hard | [Hidden in the Barren Desert Realm]
Fire Spatula | hard | remember, x marks the spot!
Flour | hard | [Hidden in Magma Canyon realm]
Fossil | hard | click on a fossil somewhere...
Fridge | hard | that's it? IT'S JUST A FRIDGE?? (Start in City)
Fronk | hard | "I'm fronk! FTBC? UGH. More like Find the BUH. Winter disapproved." (Look below the water...)
Fruit Bowl | hard | [Hidden in Classic Paradise]
GameGo | hard | [Hidden in Classic Paradise]
Gear | hard | this definitely grinds my gears (Hidden in City)
Giant Tree | hard | it's a giant tree (Start at Warehouse)
Gifty | hard | find 5 gifts around the place and then find a bunch of gifts laying around at factory
Grapefruit | hard | [Hidden in Sakura Serenity]
Grapes | hard | [Hidden in Classic Paradise]
Halporhini Cube | hard | that's a weird looking cube (Start in Warehouse)
Hamburger | hard | [Hidden in Polluted Marshlands]
Ice Cube | hard | ice?
Irony | hard | insert joke about irony here (Hidden at Factory)
Jarry | hard | [Hidden in the Backrooms]
Jawbreaker | hard | find a way onto a lollipop (Hidden in Candyland)
k | hard | [Hidden in Sakura Serenity]
Lava Lamp | hard | [Hidden in the Backrooms]
Liy | hard | find a hidden light switch somewhere
Mardi Gras Bead | hard | (Hidden in Fossil Falls)
Marimo Ball | hard | talk about camo... (Hidden in Goiky)
Meatloaf | hard | [Hidden in Classic Paradise]
Mechanical Pencil | hard | used for mechanical reasons (Start in Calculator's room)
Minty | hard | people who actually like mint are crazy and you should stay as far away from them as possible (Hidden at Hotel)
Mouthy | hard | [Hidden in Classic Paradise]
Mr. Feet | hard | [Hidden in Magma Canyon realm]
Nine | hard | oh no, he lost his skateboard! find it and click it!
Palmy | hard | underneath the map lies a upside down tree...
Pancakes | hard | [Hidden in Midnight Rooftops Realm]
Peanut Butter | hard | what? only 96 chocolate balls?? OUTRAGEOUS!! (Hidden at Hotel. Find four chocolate balls around the map)
Pebble | hard | rocks are merely big pebbles (Start in Goiky)
pen pog | hard | [Hidden in the Inverted Realm]
Penny | hard | [Hidden in the Inverted Realm]
Pi | hard | [Hidden in the Yoyleland Realm]
Pill | hard | [Hidden in the Yoyleland Realm]
Pizza | hard | [Hidden in Magma Canyon realm]
Planter | hard | [Hidden in Sakura Serenity]
Potato | hard | [Hidden in the Barren Desert Realm]
Puddle | hard | [Hidden in the BF1D Realm]
Purple Face | hard | you do not know anything, you're... PURPLE!!! (Start in City)
Redcurrant | hard | [Hidden in Classic Paradise]
Robot Loser | hard | [Hidden in the Inverted Realm]
Robot Saw | hard | [Hidden in Sakura Serenity]
Robot Tennis Ball | hard | [Hidden in Midnight Rooftops Realm]
Rollarskate | hard | A pair of skates so cool that they don't even follow the laws of physics. (Hidden at Warehouse)
Sans | hard | [Hidden in Midnight Rooftops Re- SANS?!??!!??!?]
Shoe | hard | [Hidden in Magma Canyon realm]
Shower | hard | [Hidden in the Yoyleland Realm]
Sidewalk | hard | [Hidden in Classic Paradise]
Slide Man | hard | look at em go (Hidden in Jungle)
Soul Cube | hard | [Hidden in Polluted Marshlands]
Sour Apple Sauce | hard | [Hidden in the Cherry Grove Realm]
Spark Plug | hard | find a way onto a roof (Hidden in Classic Roblox, but start at the Hotel.)
Square Lemon | hard | [Hidden in Classic Paradise]
Stabby | hard | [Hidden in the Yoyleland Realm]
Sundae | hard | nice and fresh, i sure hope it doesn't fall over (Hidden in Candyland)
Tablety | hard | find a window on the headquarters that are different from the rest
Think Emote | hard | [Hidden in the Barren Desert Realm]
Thready | hard | [Hidden in Midnight Rooftops Realm]
Titanium Knife | hard | start by finding a button in desert.
Toffee | hard | [Hidden in the Barren Desert Realm]
Tomato | hard | [Hidden in Midnight Rooftops Realm]
Tri-Tri | hard | there's something off with a nose somewhere... perhaps it's frostbite?
Tungsten | hard | she up all night grindin' my gears
Two Halves | hard | awh
Vibe Check 4 | hard | [Hidden in the Cherry Grove Realm]
Virtual Pet Lizard | hard | [Hidden in the Barren Desert Realm]
Vomit Drop | hard | look underneath a platform in a certain factory
VR Headset | hard | [Hidden in the Inverted Realm]
wax slitly weathered cut copper stairs | hard | [Hidden in Magma Canyon realm]
Yellow Face | hard | what do you use to film? (Start in City)
Yoyle Soda | hard | [Hidden in the Yoyleland Realm]
Battery | difficult | think about it, what item needs you to put a battery in?
Bicycle Wheel | difficult | [Hidden in the Yoyleland Realm]
Black Marker | difficult | how does an object simply noclip through reality? (Start in Spawn)
Blue Needle | difficult | Those legs explain some things... Hidden with her peers, obviously.
Blue Square | difficult | look in somewhere purple (Start in City)
Bluecky | difficult | i'm BLUE!!!!! DABABDEE!!!!!!! DABADI!!!!!! (Start in Fossil Falls)
Boaty | difficult | this is a VERY clutch jump (Hidden in Tropical Islands)
Box | difficult | [Hidden in the Inverted Realm]
Box Fan | difficult | inside of a factory room
Box of Free Puppies | difficult | [Hidden in the Inverted Realm]
Brick | difficult | [Hidden in the Backrooms]
Charger Box | difficult | [Hidden in the Backrooms]
Clapboard | difficult | find a way out of yellow face's room, maybe a hidden door?
Coffin | difficult | [Hidden in the Inverted Realm]
cool bracelety | difficult | [Hidden in the Cherry Grove Realm]
Daffodil | difficult | [Hidden in the Yoyleland Realm]
De Stijl | difficult | definitely the artwork of all time (Hidden in Classic Roblox)
Dora | difficult | find a way to noclip in the backrooms itself
Elevator | difficult | [Hidden in the Inverted Realm]
Em | difficult | oh em gee (Start in Fossil Falls)
Fire | difficult | don't let them get anywhere near that world ending bomb... oh for petals sake (Hidden in Warehouse)
Fish Bowl | difficult | check under the map
Folder | difficult | [Hidden in the Inverted Realm]
Four | difficult | outside of something. (Start in Goiky)
Friesland | difficult | [Hidden in the Inverted Realm]
Function | difficult | i am dearly sorry for where i put this one (Hidden at Warehouse)
Hailairhous | difficult | asdpisdau9u1jxjzkjf'sdaidps (Hidden in Snowy)
Headphones | difficult | someone threw away their headphones somewhere (Hidden near Tennis Ball)
Image | difficult | find a way into the factory room
Jelly Bread | difficult | [Hidden in the Cherry Grove Realm]
Jingle Bell | difficult | jingle jingle jingle (Start in Goiky)
Junior | difficult | david jr!!!!! real!!!! (Start in Goiky)
Kennel | difficult | [Hidden in the Yoyleland Realm]
Lasagna | difficult | box fan just needs some lasagna (Hidden in Factory)
Liberty Bell | difficult | [Hidden in the Inverted Realm]
Lily | difficult | where am i!! (Start in City)
Long Marker | difficult | uhhhhhhhhhh (Start in Goiky)
Mango | difficult | [Hidden in the Inverted Realm]
Meester Tweester | difficult | [Hidden in the Inverted Realm]
Metal Leafy | difficult | do an obby under the map.
One Way Sign | difficult | i have nothing for this one i genuinely don't (Hidden in Jungle)
Orange Cat | difficult | what a silly little guy (Hidden in Tropical Islands)
Paper | difficult | look around the hall of fame
Pastel Feather | difficult | how silly (Start in Goiky)
PDA | difficult | you have to click something on a wall
Peanut Butter Jar | difficult | [Hidden in Timber Peaks]
Piano Key | difficult | [Hidden in the Yoyleland Realm]
Pomegranatey | difficult | [Hidden in the Inverted Realm]
Portable Music Player | difficult | get into purple face's mouth
Power Outlet | difficult | [Hidden in the Backrooms]
Puffball | difficult | i believe i (can't) fly (Hidden in Goiky)
Red Balloony | difficult | [Hidden in the Inverted Realm]
S'mores | difficult | [Hidden in Timber Peaks]
Santa Hat | difficult | get to santa hat's sleigh!
Scarfy | difficult | [Hidden in the Inverted Realm]
Shampoo | difficult | maybe try checking seven's area?
Slingshot | difficult | [Hidden in the Inverted Realm]
Snowball | difficult | uh oh ball obby
Sunset | difficult | [Hidden in the Cherry Grove Realm]
Swiss Roll | difficult | three words: tap to move
Tennis Ball | difficult | there is two parts of a code in City and Snow, make sure to put /e before it!
Tennis Ball Speaker Box | difficult | in tennis ball's garbage pile
The First Frame | difficult | yeah, i know, she was so surprised (Start in Goiky)
Touch-Tone | difficult | real!!! (Start in Goiky)
Toxic Mushroom | difficult | [Hidden in the Inverted Realm]
Tropical Virtual Pet Lizard | difficult | oddly specific but ok (Hidden in Tropical Islands)
Vasey | difficult | [Hidden in Timber Peaks]
Wasabi Chips | difficult | [Hidden in Timber Peaks]
Wet Clay | difficult | poor clay never saw it coming (Start in Fossil Falls)
Win Token | difficult | this object is SLOP. (Start in Tropical Islands)
World Map | difficult | you might randomly find them while looking down
Yellow Watermelon | difficult | ceritifed materwelon (Hidden in Jungle)
Yoyle Pie | difficult | a delicate meal enjoyed by everyone... except king cake (Start in Goiky)
YSA Status | difficult | look, ok. if you had to add the 1025th character to a game about a show that only has about 150 relevant characters, what would YOU add?
Zero Dollar Bill | difficult | [Hidden in the Inverted Realm]
168,855 | extreme | [Hidden in the Cherry Grove Realm]
5 Yen Coin | extreme | [Hidden in the Barren Desert Realm]
Air Freshener | extreme | they just want to freshen the air... or the void i guess (Hidden in Candyland)
Amethyst | extreme | [Hidden in Classic Paradise]
Asteroid | extreme | [Hidden in Classic Paradise]
Autumn Leaf | extreme | [Hidden in Sakura Serenity]
Bamboo | extreme | [Hidden in Sakura Serenity]
Beach Ball | extreme | oh no, they're drowning!! press three buttons in each area to create a path: tropical islands, number playground, and candyland
Bead | extreme | that_beadyboi (Hidden in City)
Bean Can | extreme | [Hidden in Sakura Serenity]
Biscuit | extreme | [Hidden in Timber Peaks]
Blueberry Cupcake | extreme | [Hidden in Polluted Marshlands]
Bolty | extreme | [Hidden in Classic Paradise]
Bomby Plush | extreme | on the ceiling (Hidden in City)
Bug Zapper | extreme | [Hidden in Classic Paradise]
Butter Churner | extreme | [Hidden in Classic Paradise]
Butters | extreme | [Hidden in Sakura Serenity]
Cake Pop | extreme | what a lovely day innit bruv (Start in Candyland)
Clothy | extreme | [Hidden in Polluted Marshlands]
Clowny | extreme | [Hidden in the Backrooms]
Comet | extreme | push a boulder to a certain button, then return to the desert area
Controller | extreme | uhhhh cheat the obby (its a /e code)
Coolboy | extreme | [Hidden in the Yoylefactory]
Cough Drop | extreme | [Hidden in Timber Peaks]
CRT | extreme | no description
Cube | extreme | [Hidden in the Inverted Realm]
Dango | extreme | [Hidden in Midnight Rooftops Realm]
Dog Collar | extreme | they're stuck in the CRC
Dough | extreme | [Hidden in Timber Peaks]
Drum Kid | extreme | [Hidden in Polluted Marshlands]
DS | extreme | [Hidden in the Backrooms]
Earth | extreme | clip inside the interior of a building
Elbow | extreme | [Hidden in Classic Paradise]
Elephant | extreme | [Hidden in the Yoylefactory]
Emerald | extreme | [Hidden in Classic Paradise]
Evil Bubble | extreme | i'm glad that i get to do a key door puzzle. AGAIN. (Hidden in Desert, find a key)
Evil Price Tag | extreme | [Hidden in the Yoyleland Realm]
Falafel | extreme | something seems off about gelatin's menu...
FRIENDY+ | extreme | [Hidden in the Yoylefactory]
Gashapon Capsule | extreme | im (Hidden in Snowy)
Glitter Bottle | extreme | [Hidden in Midnight Rooftops Realm]
Green Square | extreme | (Hidden in Jungle)
Hashy | extreme | [Hidden in the Barren Desert Realm]
Homeless Spooky | extreme | spooky needs money help him (Start in Hotel, find a hat)(Made by @Just_Summa)
Horn | extreme | [Hidden in Sakura Serenity]
Hot Sauce | extreme | [Hidden in Midnight Rooftops Realm]
Ice Cream Cone | extreme | [Hidden in Midnight Rooftops Realm]
Icicle | extreme | [Hidden in the Backrooms]
Income Tax Return Document | extreme | just thinking about their life decisions... (Start in City)
Ink Ball | extreme | [Hidden in the Yoyleland Realm]
Irregular Polygon | extreme | is it REALLY a polygon if it has circular sides? (Hidden near... something red, in the sky) (Made by NTailsGoBrrrrr)
Jello | extreme | [Hidden in the Inverted Realm]
Lancer | extreme | [Hidden in Classic Paradise]
Latte | extreme | [Hidden in Classic Paradise]
Lava Ball | extreme | >:) (Start in Desert)
Lego Brick | extreme | don't step on it please i'm begging you (Hidden in Desert)
Line Coin | extreme | [Hidden in Midnight Rooftops Realm]
Little Baby Pizza | extreme | [Hidden in Midnight Rooftops Realm]
Locket | extreme | [Hidden in Sakura Serenity]
Magnet | extreme | [Hidden in Midnight Rooftops Realm]
Mattress | extreme | [Hidden in the Yoylefactory]
Meatball | extreme | [Hidden in Magma Canyon realm]
Microwave | extreme | chilling at the worst possible spot (Start in City)
Mocha | extreme | do i need it? (Start in Candyland)
Na | extreme | [Hidden in Magma Canyon realm]
Omega | extreme | omaga
Oyster | extreme | [Hidden in the Barren Desert Realm]
PB&J Sandwich | extreme | [Hidden in Midnight Rooftops Realm]
Peapod | extreme | [Hidden in Classic Paradise]
Phantastrophy | extreme | [Hidden in the Yoylefactory]
Phone | extreme | [Hidden in the Backrooms]
Pie | extreme | mari? oh... (Start in Candyland)
Pink Cary | extreme | [Hidden in the Inverted Realm]
Pixely | extreme | don't worry it's not actually the size of a pixel (Hidden in Jungle)
Poison Marker | extreme | [Hidden in the Yoyleland Realm]
Poker Chip | extreme | something red... (Hidden in City)
Poop | extreme | [Hidden in the Backrooms]
Poppy Seed Roll | extreme | [Hidden in Polluted Marshlands]
Puffball Speaker Box | extreme | it's cake at STAAAAAAAAAAAAA (Start in Candyland)
Quiver | extreme | [Hidden in Classic Paradise]
Raising Cane's Cup | extreme | who up raising they canes rn (Made by lowk3y_TJ) (Start in Candyland)
Red Mushroom | extreme |  (Start in Candyland)
refsbcj | extreme | [Hidden in Magma Canyon realm]
Revolver | extreme | high from the ground somewhere, you will need some people to help
Ribbon | extreme | [Hidden in the Inverted Realm]
Robot Cake | extreme | [Hidden in Classic Paradise]
Robot Firey | extreme | [Hidden in the Yoyleland Realm]
Robot Puppet | extreme | [Hidden in Magma Canyon realm]
Shoiyta | extreme | I.. I'M SHOIYTA!!!!! i know this is from greeny's grand game but i just couldn't resist it (Hidden in Desert)
Shrimp Tempura | extreme | [Hidden in Magma Canyon realm]
Snickerdoodle | extreme | [Hidden in Sakura Serenity]
Snowglobe | extreme | [Hidden in the Backrooms]
Softball | extreme | [Hidden in the Barren Desert Realm]
Specimum Sandwich | extreme | [Hidden in the Inverted Realm]
Spider Ball | extreme | [Hidden in Classic Paradise]
Spray Can | extreme | [Hidden in Midnight Rooftops Realm]
Steamboat Hat | extreme | one must imagine steamboat hat happy (Start in Factory)
Strudel | extreme | there is so little detail on this that it doesn't even resemble a strudel anymore (Start in Candyland)
Swordy | extreme | [Hidden in the Yoyleland Realm]
Taco With Tophat | extreme | what a fancy taco (Hidden in Jungle)
Taiyaki | extreme | [Hidden in Sakura Serenity]
Tune | extreme | find a pair of headphones in tennis ball's room
Uni | extreme | they gave up pushing that boulder after so many years (Hidden at Factory... sorta)
Vanilla Milkshake | extreme | i don't care what anyone has to say, vanilla is the goat (Start in Candyland)
Vomit | extreme | [Hidden in Midnight Rooftops Realm]
Weird Speaker Box | extreme | walk a long way after announcer (Start in City)
Yellow Pancake | extreme | [Hidden in the Inverted Realm]
Ace of Clubs | unforgiving | [Hidden in the Yoylefactory]
Algodoo Marble | unforgiving | [Hidden in Timber Peaks]
Announcer x 1222 | unforgiving | [Hidden in the Backrooms]
Backpack | unforgiving | [Hidden in the Inverted Realm]
Badge | unforgiving | [Hidden in the Backrooms]
Base Charger | unforgiving | [Hidden in the Yoylefactory]
Beanbag | unforgiving | comfiest chair in the world (Start in City)
Bell Pepper | unforgiving | [Hidden in the Cherry Grove Realm]
Black Square | unforgiving | [Hidden in the Backrooms]
Blueberry Machine | unforgiving | [Hidden in the Backrooms]
Bodywash Soapy | unforgiving | [Hidden in the Backrooms]
Bolf Gall | unforgiving | [Hidden in the Yoyleland Realm]
Cake | unforgiving | the cake is a lie (Start in PDA's Room)
Chips | unforgiving | [Hidden in Timber Peaks]
Coffee Mug | unforgiving | [Hidden in the Yoylefactory]
Credit Card | unforgiving | Okay, so if you just tell me your credit card number as well as the three little numbers on the back, you can get this object! Deal? (Start in City)
Danger Sign | unforgiving | [Hidden in the Backrooms]
Delicious Fruit | unforgiving | [Hidden in the Yoylefactory]
Demonic Painting | unforgiving | what a joyous painting! (Made by Ohlegess) (Start in Goiky)
Diamond | unforgiving | [Hidden in the Yoylefactory]
Drilly | unforgiving | clip out of bounds then clip out of the clipped bounds... clipception
Earphone Shotgun | unforgiving | corner clip on a suspicious wall (press F)
Exploding David | unforgiving | ruh roh.. who gave david a bomb head (Start in City)
Feet | unforgiving | find a controller in the headquarters
Firey Speaker Box | unforgiving | gotta complete an obby (Start in Desert)
Four's Uncle Craig | unforgiving | [Hidden in the Yoylefactory]
Frog | unforgiving | [Hidden in Timber Peaks]
Gramophone | unforgiving | [Hidden in the Inverted Realm]
Gumbally | unforgiving | someone put their gum under the table.... of course (Start in Goiky)
Lampy | unforgiving | don't ask why this one is insane difficulty (Start in Goiky)
Laundry Basket | unforgiving | [Hidden in the Backrooms]
Leafy Jr. | unforgiving | if there is a leafy jr. then what would evil leafy jr. look like? (Hidden in Jungle)
Locker | unforgiving | [Hidden in the Backrooms]
Match Box | unforgiving | [Hidden in the Yoyleland Realm]
Max | unforgiving | [Hidden in the Inverted Realm]
Monarch | unforgiving | why is it called a monarch why why wh (Start in Goiky)
Morganite | unforgiving | [Hidden in the Backrooms]
Mouse Trap | unforgiving | [Hidden in the Inverted Realm]
Music Box | unforgiving | [Hidden in the Backrooms]
Obsidian | unforgiving | [Hidden in the Inverted Realm]
One Recommended Character Per Recommender Sign | unforgiving | [Hidden in the Backrooms]
Onigiri | unforgiving | don't even think about pushing that button... (Start in City)
Ordinary Banana... | unforgiving | what time is it??? find three buttons in floating island, classic roblox, and somewhere else.. (Made by This_manisnothim)
Paint Bucket | unforgiving | [Hidden in the Yoylefactory]
Paint Drop | unforgiving | [Hidden in the Yoyleland Realm]
Peanut | unforgiving | look inside of the jungle trees
Pesticide | unforgiving | [Hidden in the Inverted Realm]
Plus | unforgiving | [Hidden in the Backrooms]
Quartz | unforgiving | find a key to a crate
Rainbow Orb | unforgiving | [Hidden in the Backrooms]
Robot Leafy | unforgiving | [Hidden in the Yoyleland Realm]
Roboty-y | unforgiving | i think it should be clear where this one is located
Seedling | unforgiving | [Hidden in the Yoylefactory]
Sickle | unforgiving | [Hidden in the Inverted Realm]
Spike Ball | unforgiving | don't like moving forests? then maybe you'd like this (Start in Goiky)
Squeaky Hammer | unforgiving | [Hidden in the Yoyleland Realm]
Steel Drum | unforgiving | [Hidden in the Inverted Realm]
Stool | unforgiving | look around in classic roblox
Stringy | unforgiving | [Hidden in the Inverted Realm]
Sun | unforgiving | wait.. the SUN?!?!? (Hidden in Goiky)
Teabag | unforgiving | [Hidden in the Yoylefactory]
Text Message | unforgiving | [Hidden in the Yoylefactory]
Thirteen | unforgiving | not gonna say where, but its near something purple
Tombstone | unforgiving | rip (Hidden in Fossil Falls)
Ushanka | unforgiving | [Hidden in the Backrooms]
Wasabi | unforgiving | [Hidden in the Yoyleland Realm]
Watermelon | unforgiving | [Hidden in the Yoylefactory]
Yellow Leopard | unforgiving | heck (Hidden in Desert)
Yoyle Spoon | unforgiving | [Hidden in Timber Peaks]
Zombified Barf Bag | unforgiving | find a wrench to unlock access to the sewers
Austrian Shield | insane | [Hidden in Polluted Marshlands]
B.O.D | insane | [Hidden in the Backrooms]
Beetroot | insane | [Hidden in Classic Paradise]
BFDIA 5b | insane | [Hidden in Classic Paradise]
Black Hole | insane | There are pieces of code scattered throughout Spawn and Snow areas, find all 5 pieces and then go to Factory area.
Blob of Syrup | insane | [Hidden in Polluted Marshlands]
Block of Glass | insane | [Hidden in the Yoylefactory]
Branchy | insane | [Hidden in Polluted Marshlands]
Bread Coiny | insane | [Hidden in Midnight Rooftops Realm]
Bubble | insane | oh lord why do i love invisible platforms so much. (Start in City)
Buh | insane | hey guys, it's me, buh! and welcome... to the buh-ly object show! (Start in Warehouse)
Burger Blanket | insane | [Hidden in Midnight Rooftops Realm]
ca2 | insane | [Hidden in Magma Canyon realm]
Calamari Ring | insane | [Hidden in Classic Paradise]
Cardy | insane | [Hidden in Magma Canyon realm]
China | insane | [Hidden in Polluted Marshlands]
Chocolate Circle | insane | [Hidden in Sakura Serenity]
City of LAy | insane | [Hidden in the Inverted Realm]
Crystal Firey | insane | [Hidden in Classic Paradise]
Cuber | insane | [Hidden in the Backrooms]
Cup Stacky | insane | [Hidden in the Backrooms]
Davidy | insane | [Hidden in Sakura Serenity]
Dioptase | insane | [Hidden in Classic Paradise]
Electrostatic | insane | [Hidden in the Yoylefactory]
Erlenmeyer | insane | [Hidden in Magma Canyon realm]
Evil Firey | insane | [Hidden in the Evil Forest Realm]
Feather | insane | he's way too far in the sky for you to reach... perhaps if you had a friend to help?
Fernandez | insane | [Hidden in the Barren Desert Realm]
Flower Speaker Box | insane | shes near firey speaker box
Four Colored Gelatin | insane | GELATIN WHAT DID THEY DO TO YOU (Start in Goiky)
Frame | insane | [Hidden in the Inverted Realm]
Frog Four | insane | [Hidden in the Yoyleland Realm]
Frozen Yogurt | insane | Start in Candyland
Geode | insane | Just another hump of trash in the sewers.(Start at Hotel)
Gingerbread Man | insane | do you know the muffin man (Start in Number Playground)
Glowstick | insane | [Hidden in the Yoylefactory]
Goldy | insane | [Hidden in Midnight Rooftops Realm]
Hanheld | insane | [Hidden in the Yoylefactory]
Humorous Hummus | insane | [Hidden in Sakura Serenity]
Hyper | insane | [Hidden in the Inverted Realm]
Ice Bracelety | insane | [Hidden in the Barren Desert Realm]
Impostory | insane | [Hidden in Midnight Rooftops Realm]
Infinity | insane | [Hidden in Classic Paradise]
Ink | insane | [Hidden in the Inverted Realm]
Inverted Cursor | insane | ]mlaeR spotfooR thgindiM ni neddiH[
Iolite | insane | [Hidden in Classic Paradise]
Juice Box | insane | [Hidden in the Yoylefactory]
Laser Pointer | insane | not exactly the most ideal place to be (Start in City)
Magney | insane | [Hidden in Classic Paradise]
Maroon Ball | insane | [Hidden in the Yoylefactory]
Milky | insane | [Hidden in Midnight Rooftops Realm]
Mojito Glass | insane | [Hidden in Polluted Marshlands]
Mous.V | insane | [Hidden in Timber Peaks]
MousePad | insane | [Hidden in the Yoylefactory]
Not Canon | insane | [Hidden in Midnight Rooftops Realm]
oblique pentagonal prism | insane | [Hidden in the Cherry Grove Realm]
Ottoman | insane | [Hidden in the Inverted Realm]
owoball | insane | [Hidden in the Yoylefactory]
Pan Flute | insane | [Hidden in the Barren Desert Realm]
Peach | insane | [Hidden in Classic Paradise]
Piano | insane | [Hidden in the Yoylefactory]
Pink Lemonade | insane | [Hidden in Polluted Marshlands]
Plant | insane | [Hidden in Sakura Serenity]
Popsicle | insane | [Hidden in the Yoylefactory]
Pride Cat Firey | insane | rawr nya X3 (Start in City)
Pugsley | insane | [Hidden in the Yoylefactory]
Rainbow Cloudy | insane | [Hidden in Midnight Rooftops Realm]
Rainbow Slinky | insane | [Hidden in Classic Paradise]
Red Leaf | insane | [Hidden in Sakura Serenity]
Rubber Ball | insane | [Hidden in the Yoylefactory]
Shinyleaf | insane | oooo shiny (Start in Candyland)
SimOndoMino | insane | [Hidden in Midnight Rooftops Realm]
Sippy | insane | hmmmmmmmmmmmmmmmmmmmmmmmmm (Start in City)
Sky | insane | [Hidden in the Yoyleland Realm]
Spikey | insane | [Hidden in Sakura Serenity]
Square Root | insane | [Hidden in Timber Peaks]
Starfruit | insane | [Hidden in Polluted Marshlands]
Starie | insane | [Hidden in Midnight Rooftops Realm]
Stickynotes | insane | [Hidden in the Yoylefactory]
Stump | insane | [Hidden in Timber Peaks]
THE GET AWAY FROM ME BUTTON!!!!!!! | insane | looks like two dropped his button somewhere
Thermometer | insane | [Hidden in Timber Peaks]
Toothbrush | insane | [Hidden in the Inverted Realm]
Trash Can | insane | heya mmm no hints!
Trashbag | insane | [Hidden in the Yoylefactory]
Two | insane | invisible platforms are cool. (Start in Goiky)
Vinyl Record | insane | [Hidden in Timber Peaks]
W | insane | [Hidden in Midnight Rooftops Realm]
Wild West Painting | insane | [Hidden in the Backrooms]
X | insane | kick down something... (Start in Goiky)
Accordion | dreadful | [Hidden in the Backrooms]
Aura Sphere | dreadful | [Hidden in the Yoylefactory]
Bandana | dreadful | find a pathway that leads somewhere outside (Start in City)
Blackbelt | dreadful | [Start in the Yoylefactory Realm]
Candle | dreadful | [Hidden in Timber Peaks]
Candy Wrapper | dreadful | [Hidden in the Yoylefactory]
Carbon Dioxide | dreadful | [Start in the Yoylefactory Realm]
Cheeseburger | dreadful | [Hidden in Timber Peaks]
Cherryade | dreadful | [Start in the Yoylefactory Realm]
Civil Siren | dreadful | [Hidden in the Backrooms]
Clickbait Arrow | dreadful | [Hidden in Classic Paradise]
d | dreadful | hidden somewhere that contains a d (Start in Tennis Ball's room)
Demon Ball | dreadful | [Hidden in the Inverted Realm]
DUMMY3 | dreadful | [Hidden in the Yoylefactory]
Evil Book | dreadful | [Hidden in the Evil Forest Realm]
Evil Gelatin | dreadful | [Hidden in the Evil Forest Realm]
Evil Jarry | dreadful | [Hidden in the Evil Forest Realm]
Evil Spongy | dreadful | [Hidden in the Evil Forest Realm]
Fermata | dreadful | [Hidden in the Backrooms]
Gold Block | dreadful | [Hidden in the Inverted Realm]
Graphics Card | dreadful | [Hidden in the Yoylefactory]
Hoodie | dreadful | [Start in the Yoylefactory Realm]
Immortality Thing | dreadful | IMMORTALITY!!!!!!! (Start at Hotel) (Made by KingOfChomiks90)
IV Bag | dreadful | [Hidden in the Yoyleland Realm]
Jabuticaba | dreadful | [Hidden in the Inverted Realm]
Jellybean Jar | dreadful | that's a nice jar of jellybeans there (Made by lowk3y_TJ) (Hidden in Candyland)
Karate Pot | dreadful | [Hidden in the Backrooms]
Leafmote | dreadful | [Hidden in the Yoylefactory]
Lipstick | dreadful | [Hidden in the Yoyleland Realm]
Lithium | dreadful | [Hidden in the Yoylefactory]
Mangosteen | dreadful | [Hidden in the Yoyleland Realm]
Mason | dreadful | [Hidden in the Backrooms]
MissingYes | dreadful | [Hidden in the Yoylefactory]
Mouse Guy | dreadful | [Hidden in the Yoylefactory]
Oodle | dreadful | something lies deeper within the EXIT...
Piece of Glass | dreadful | [Hidden in the Inverted Realm]
Princess Flower | dreadful | [Hidden in the Inverted Realm]
Pykrete | dreadful | [Hidden in the Cherry Grove Realm]
Raisin | dreadful | [Hidden in the Yoylefactory]
Sad Cloudy | dreadful | find yourself in an unfortunate predicament after trying to cheese a certain character
Safe | dreadful | he's safe to where no one can find him... right? (Start in City)
Skateboard | dreadful | [Hidden in the Backrooms]
Spammy | dreadful | [Hidden in Timber Peaks]
Spatula | dreadful | [Hidden in the Yoylefactory]
Swirl | dreadful | [Hidden in the Backrooms]
Torch | dreadful | it's torc (Start at Factory)
Torn Pillow | dreadful | [Hidden in the Evil Forest Realm]
Tornado | dreadful | find a ladder that leads outside
Toxic Bomb | dreadful | [Hidden in the Inverted Realm]
Troll Face | dreadful | problem? (Start at Factory, get trolled.)
Vacuum | dreadful | [Hidden in the Yoyleland Realm]
White Board | dreadful | [Hidden in the Yoylefactory]
Wizard Hat | dreadful | [Hidden in the Yoylefactory]
-8 Ball | terrifying | [Hidden in the Yoylefactory]
2009 Firey | terrifying | [Hidden in Classic Paradise]
[Loading Object] | terrifying | Loading selected realm...
Amber | terrifying | [Hidden in the Cherry Grove Realm]
Among Us Four | terrifying | [Hidden in the Yoylefactory]
Button | terrifying | [Hidden in the Yoylefactory]
Checkered Flag | terrifying | [Hidden in the Inverted Realm]
Chicken Nuggets | terrifying | find a way to destroy a barrel at desert. anything for the nuggets!!!
cool ice cube | terrifying | [Hidden in Midnight Rooftops Realm]
Cord | terrifying | [Hidden in the Backrooms]
Cremini | terrifying | [Hidden in Midnight Rooftops Realm]
Deadly | terrifying | [Hidden in Classic Paradise]
Dragonman | terrifying | [Hidden in Polluted Marshlands]
Electronic Game | terrifying | [Hidden in Midnight Rooftops Realm]
Every Character Fused | terrifying | [Hidden in Midnight Rooftops Realm]
Evidence Bag | terrifying | to see this description first you must find evidence of DEEZ NU- (Start in Factory)
Evil David | terrifying | [Hidden in the Evil Forest Realm]
Fake Firey | terrifying | [Hidden in the Backrooms]
FLA | terrifying | [Start in the Yoylefactory Realm]
Gaming Controller | terrifying | [Hidden in the Yoylefactory]
Geocache | terrifying | [Hidden in the Inverted Realm]
Grarblicker | terrifying | [Hidden in Classic Paradise]
Literal Air | terrifying | [Hidden in the Cherry Grove Realm]
Missing Texture Block | terrifying | [Hidden in the Yoylefactory]
Network Cable Tester | terrifying | [Hidden in Timber Peaks]
Nightlighty | terrifying | [Hidden in the Backrooms]
Non-Slip Shoes so Ha | terrifying | [Hidden in Sakura Serenity]
oMg | terrifying | [Hidden in Sakura Serenity]
Paper Jam Leafy | terrifying | [Start in the Yoylefactory Realm]
Piece of String | terrifying | [Start in the Yoylefactory Realm]
Quereltrajankyn | terrifying | what in the world is that (Made by KingOfChomiks90), (Start in spawn, maybe look up?)
Radio | terrifying | [Hidden in Midnight Rooftops Realm]
RAM Chip | terrifying | [Hidden in the Yoylefactory]
Red crayon who is also blue but probably isn't green | terrifying | [Hidden in Sakura Serenity]
ReplicatedStorage | terrifying | start in classic paradise. find a teleporter. (Made by ThirteenthJade)
Robot Liy | terrifying | [Start in the Yoylefactory Realm]
Sharp | terrifying | honey, you okay? you'VE haRd1y t0ucHed YOur !(%!^*@!^! (Start  in Candyland, drop down)
Sierpinski | terrifying | [Hidden in the Barren Desert Realm]
Slime Flashlight | terrifying | press a button in a mechanical area to drain out some slime (Made by KingOfChomiks90)
Soy | terrifying | [Hidden in Polluted Marshlands]
Spinel | terrifying | [Hidden in Classic Paradise]
Sponge Cake | terrifying | [Hidden in the Barren Desert Realm]
Stylus | terrifying | [Hidden in the Yoylefactory]
Theebs | terrifying | [Hidden in Polluted Marshlands]
This is Sparta-Y | terrifying | ...madness? (Start in Desert)
Three-Leaf Clover | terrifying | [Hidden in Classic Paradise]
Torso | terrifying | [Hidden in Polluted Marshlands]
Up Arrow | terrifying | [Hidden in Classic Paradise]
Veterany | terrifying | [Start in Classic Paradise]
Wildy | terrifying | [Hidden in Sakura Serenity]
Yin-Yang | terrifying | [Start in the Yoylefactory Realm]
Your Mom | terrifying | [Hidden in Midnight Rooftops Realm]
A BFDI | arduous | [Hidden in the Yoyleland Realm]
Alien | arduous | find 8 buttons scattered around the entire overworld, no hints!
Ampersand | arduous | [Hidden in the Yoylefactory]
Boblob | arduous | start by looking near black hole
Burger | arduous | MUST.... OBTAIN.... THE BURGER!!!!!!!! (Start in the Fourest)
Demon Four | arduous | [Start in the Yoylefactory Realm]
Desert Pillar | arduous | [Hidden in the Inverted Realm]
Dot | arduous | [Hidden in the Timber Peaks Realm]
Dragon | arduous | [Hidden in the Cherry Grove Realm]
Evil Pin | arduous | [Hidden in the Evil Forest Realm]
Filler | arduous | we love filler objects here! also i'm not giving you a hint.
Font | arduous | [Hidden in the Yoylefactory]
Gaming Device | arduous | [Hidden in the Yoylefactory]
Lemi12 | arduous | [Start in the Yoylefactory Realm]
Nanoboty | arduous | want to do some math? no? well too bad!
Nonexisty | arduous | up in the sky?
Nutty | arduous | [Hidden in Timber Peaks]
PUMPKIN 2.0 | arduous | [Hidden in the Timber Peaks Realm]
Shuttle Birdie | arduous | [Start in the Yoylefactory Realm]
Spongezilla | arduous | [Hidden in the Yoyleland Realm]
Studio | arduous | start by finding a QR code on the main map, you must have roblox studio to get this one! (Made by NTailsGoBrrrrr)
Throne | arduous | near the FORBIDDEN ORB.
Tiddles | arduous | yellowstickmanyt killed his pet fish tiddles, by throwing him out a window. now he's a cat's lunch!
Ulm | arduous | look near where fedora is
Virus | arduous | [Hidden in Timber Peaks]
Wolfy | arduous | [Hidden in the Backrooms]
? | strenuous | [Hidden in Sakura Serenity]
average joe | strenuous | [Start in the Yoylefactory Realm]
Bandy | strenuous | [Hidden in Midnight Rooftops Realm]
BEEP Fusion | strenuous | start in level 4 of the backrooms, and find the stairwell
Birdie | strenuous | [Hidden in Classic Paradise]
blocky on toilet | strenuous | [Hidden in Midnight Rooftops Realm]
Blue Screen of Death | strenuous | [Hidden in the Yoylefactory]
Brainy | strenuous | you need a BIG BRAIN to understand this one. (Hidden in Hall of Fame, but start in Midnight Rooftops. Then, go to the park behind City and insert the correct color combination.)
Cat Witch | strenuous | [Hidden in Polluted Marshlands]
Cauldron | strenuous | find three potions to finish off the cauldron in the jungle. (Made by Just_Summa)
Cobalty | strenuous | [Start in the Yoylefactory Realm]
Deep Fried Breath | strenuous | [Hidden in the Barren Desert Realm]
Dynamite | strenuous | [Hidden in Magma Canyon realm]
Evily | strenuous | [Hidden in the Evil Forest Realm]
Evry Charecter Fused | strenuous | sometimes, i wonder, what is the point of making this game? after all, it's not like in the future this game will be relevant, and besides, there's going to be an end to this game sometime. so what's the point? i could go on and on about why i think it's pointless to work on this game, but it isn't worth it. i guess, i think it's my passion project, i wanna do good, y'know? spooky and funky don't necessarily update this game often, and i feel like... without me, the game wouldn't be where it is today, not to brag though. i mean, we're almost to 1000 objects, and it MIGHT be 1000 objects depending on when you're reading this.
Fax Machine | strenuous | [Hidden in the Yoyleland Realm]
Fedora | strenuous | ycjvv??? hkpf c vgzv kp urcyp, crrna ucog ekrjgt
Frozen Steak | strenuous | [Hidden in the Frozen World Realm]
Galaxy Pillow | strenuous | [Hidden in the Backrooms]
Glitchy | strenuous | YOU SHOULDN'T BE HERE
Grandfather Clock | strenuous | [Hidden in the Backrooms]
Ground | strenuous | [Hidden in the Yoylefactory]
Hornbox | strenuous | the hero that we didn't deserve but needed (Start in Tennis Ball's room)
King Cake | strenuous | [Hidden somewhere else...]
King Skull | strenuous | find 14 pieces of code around the entire map, in red text
Magnifying Glass | strenuous | [Start in the Yoylefactory Realm]
Metronome | strenuous | [Hidden in the Backrooms]
Money Bag | strenuous | [Hidden in the Yoylefactory]
Octahedron | strenuous | [Hidden in the Frozen World Realm]
Oxygen | strenuous | [Hidden in Classic Paradise]
Placeholdery | strenuous | [Hidden in the Backrooms]
Plastic Sun | strenuous | [Hidden in Classic Paradise]
Poison Cake | strenuous | aka "Poise" (Located in Candyland)
Rock | strenuous | [Hidden in Midnight Rooftops Realm]
Rosin | strenuous | [Hidden in the Frozen World Realm]
Sausage Roll | strenuous | [Hidden in Classic Paradise]
Singapore Map | strenuous | [Hidden in Midnight Rooftops Realm]
Transmitter | strenuous | beep beep beep bep bep bep bop bep bep bep beep beep (Start near Roboty)
Zomball | strenuous | [Hidden in an unknown realm]
Zombified Clapboard | strenuous | [Hidden in an unknown realm]
Zombified Coiny | strenuous | [Hidden in an unknown realm]
Zombified Conch Shell | strenuous | [Hidden in an unknown realm]
Zombified Snowball | strenuous | [Hidden in an unknown realm]
Zombified Two | strenuous | [Hidden in an unknown realm]
A BFDIA | remorseless | [Hidden in the Yoyleland Realm]
Administratory | remorseless | [Start in Classic Paradise]
ARG Television | remorseless | start in firey speakerbox's area
Aurora Borealis | remorseless | [Hidden in Midnight Rooftops Realm]
BFB 1-29 Thumbnail Fusion | remorseless | [Hidden in Midnight Rooftops Realm]
Bird From Egypt | remorseless | [Hidden in Classic Paradise]
Cali | remorseless | [Start in the Yoylefactory Realm]
Chartreuse | remorseless | start in the throne room and find a way upwards
Corrupted Firey | remorseless | [Hidden in Midnight Rooftops Realm]
Front Facing Marker | remorseless | the method to get this is a complete secret. all i'll tell you is that you should try searching for something...
Hot Cheese Puff | remorseless | [Hidden in the Barren Desert Realm]
Ice Chunk | remorseless | [Hidden in the Frozen World Realm]
Jade | remorseless | [Hidden in Classic Paradise]
Moon | remorseless | [Hidden in Sakura Serenity]
Motionless | remorseless | AAAAAAAAAAAAAAAAAAAAA      (Made by AccountDoesNothing)
Obelus | remorseless | [Hidden in the Backrooms]
Orange Gemstone | remorseless | [Hidden in the Cherry Grove Realm]
Remote Event | remorseless | they look like they would get along so well! (Start in the Fourest)
SilvaGunner | remorseless | GRAND DAD?!? (Start in Goiky)
Soldery | remorseless | [Start in the Yoylefactory Realm]
Storm Ball | remorseless | The eye of the storm. (Hidden in Factory, find four buttons.)
USB Drive | remorseless | [Hidden in Midnight Rooftops Realm]
Winterous | remorseless | [Hidden in the Frozen World Realm]
Yellow Gemstone | remorseless | [Hidden in the Cherry Grove Realm]
You Tried Star | remorseless | [Hidden in the Barren Desert Realm]
Boltzmann's Brain | horrifying | begin by looking within the eye of the storm
Cake's Dad | horrifying | 
Contestants | horrifying | start by looking for a portal under the map
Dragonfruit | horrifying | this one is a button hunt
Freeze Juice | horrifying | your actions have consequences.
Peep | horrifying | peep. for the easter event. find fifteen eggs in fifteen realms!
Pesky Pentagon | horrifying | start in the backrooms. that's all.
Radioactive TV | horrifying | begin by looking through somewhere completely abandoned
Slimy | horrifying | start with a youtube link in midnight rooftops. capital letters only. the rest is up to you. be sure to return to midnight rooftops as well.
Sphere of Benevolence | horrifying | start by finding something in an unknown realm...  (Made by Cadalac8999)
Starwalker | horrifying | i am the original               starwalker
This Monstrosity | horrifying | begin by dropping down in the evil forest (Made by dnifnfi)
Wand | horrifying | the only way to get wand is by asking a certain object... perhaps a skull?
EVERYTHING | IMPOSSIBLE | woah it's the everything chomik ripoff who could forget
Hypostasis | IMPOSSIBLE | Hypostasis is the only being capable of nullifying the mere crystallization of the universe. Start in Frozen World, a badge description may help you.
The Crystallized Core | IMPOSSIBLE | The four crystals: knowledge... death... perseverance... benevolence... start by finding the latter. (Made by Cadalac8999)
Great Rhombicosidodecahedron |  | Is this the real life?
Bronze Medal | medal | ^^
Diamond Medal | medal | ^^
Gold Medal | medal | ^^
Silver Medal | medal | ^^
Void Medal | medal | ^^

== BACKROOMS OBJECTS ==
Clay | intermediate | did you know that i ate playdoh when i was 4 years old
Computer | intermediate | awaiting you at the exit
Ringy | intermediate | oh....
Jarry | hard | find a shelf somewhere
Lava Lamp | hard | do i even have to explain?
Poop | hard | this description is a piece of POOP!!!!
Black Square | extreme | i remember when black square went "it's black squarin' time" and black squared all over the place
Brick | extreme | oh no oh god why am i here
Charger Box | extreme | he isn't on the outlet he isn't on the outlet he isn't on the outlet he isn't on the outlet he isn't on the outlet
Cuber | extreme | [proceeds to update level 0 without explanation]
DS | extreme | he's such a gamer, he doesn't even need friends!
Icicle | extreme | inside a puddle of water
Power Outlet | extreme | remember when power outlet went "it's outlin' time" and outted all over the pl
Snowglobe | extreme | can you believe it guys? christmas! just a week away!
Announcer x 1222 | insane | you can't actually see him, despite being multiplied by 1222
Badge | insane | awaiting you at the exit
Blueberry Machine | insane | you give me: money, i give you: balls
Clowny | insane | HEY KIDS
Danger Sign | insane | what could be inside that very tiny proportionately sized hallway?
Locker | insane | it was just... a locker?
Music Box | insane | i simply don't know what to put here
One Recommended Character Per Recommender Sign | insane | he is not off-balance, hooray for him!
Phone | insane | find a wall you can noclip through
Plus | insane | find a ladder.. or not
Rainbow Orb | insane | congratulations, you've made it to level 4!
Accordion | dreadful | yes very accordion-like accordion accordion acc
Civil Siren | dreadful | WEE WOO WEE WOO!!!
Fermata | dreadful | look near a broken wall
Karate Pot | dreadful | i'm a... pot!!!!
Skateboard | dreadful | some people are blessed with talent
Bodywash Soapy | terrifying | complete an invisible maze
Cord | terrifying | sticking out of a vending machine
Cup Stacky | terrifying | they are stacking cups alone
Laundry Basket | terrifying | inside of a room with a mop
Mason | terrifying | i can't say the actual OC name unfortunately, but also this is annoying
Morganite | terrifying | find a way out of the map
Swirl | terrifying | MUAHAHA!!! a backrooms update!!! bet you weren't expecting that
Ushanka | terrifying | in russia, ushanka puts on you
Wild West Painting | terrifying | this truly shows everything about society
Fake Firey | arduous | caught you, faker!
Wolfy | arduous | behind a file cabinet
Galaxy Pillow | strenuous | there's a slightly miscolored locker.. look around it
Grandfather Clock | strenuous | i'll give you time to think about this one...
Metronome | strenuous | think about the song that plays
Nightlighty | strenuous | hope you aren't afraid of the dark >:)
Placeholdery | strenuous | this description is still a placeholder
Obelus | remorseless | the obelus is real..........

== BARREN DESERT OBJECTS ==
Bag of Sand | easy | hmm yes bag of sand
Bow And Arrow | easy | next to some other bows
Cheese Orb | easy | cheese orb is in the game. peace has been restored
Churro | easy | yeah
Curly Arrow | easy | no way!!!!! real!!!
Magic Conch | easy | look near where conch shell was in the main realm
Sand Clock | easy | look in one of those buildings
Can of Black Olives | normal | look around the map
Cardboard | normal | he's doing stuff n' things
Cheese Slice | normal | look in the abandoned hamlet
Ellipsis | normal | this one is at...
Firey Jr. Jr. | normal | at this point you can't even SEE him
Hazelnut | normal | hazelnut :DDDDD
Johnson | normal | the johnson is real
Robot Woody | normal | [insert robot screaming]
Wicker Basket | normal | there's a rusty building, look inside of it
Bacon Bit | hard | is it controbersial to say that i don't like bacon? it tastes.. awful
Fire Melon | hard | this melon is on fire!!!
Potato | hard | find some potatoes lying around
Think Emote | hard | this may require you to THINK about it
Toffee | hard | i have never heard of toffee before in my life
Virtual Pet Lizard | hard | find a wonky looking cactus
5 Yen Coin | extreme | donut is looking a little different today
Hashy | extreme | complete the obby near spawn!
Oyster | extreme | check the ceiling
Softball | extreme | there's a giant cactus, i think you can see it..
Fernandez | insane | reach towards the sun
Ice Bracelety | insane | ice in the desert? how does that make any sense
Pan Flute | insane | IT'S IN THE GOSH DARN WALLS!!!!
Sierpinski | terrifying | uhm.. what??? also, look under the map
Sponge Cake | terrifying | 1... 2... 3... 4... who do we? not adore? spongy!!! spongy!!! spongy!!!
Deep Fried Breath | strenuous | find yourself somewhere unprecedented
You Tried Star | strenuous | complete the four trials
Hot Cheese Puff | remorseless | find an encrypted message

== CLASSIC PARADISE OBJECTS ==
Broccoli | intermediate | Just having a picnic!
Buzzer | intermediate | The big red buzzer in a building.
GameGo | intermediate | Near one of the bridges.
Latte | intermediate | Near the gigantic tree, just chilling.
Mouthy | intermediate | On the beach.
Pear Tree | intermediate | Hidden in Greenhouse, try to get up the big pear tree.
Sidewalk | intermediate | On a sidewalk, where else do you think it would be?
Square Lemon | intermediate | Someone tell them to stop being so sour. (Hidden in Greenhouse)
Violet | intermediate | In the greenhouse, with all of her siblings!
Container | hard | Look on an island near spawn.
Fruit Bowl | hard | At one of the smaller islands in Greenhouse.
Grapes | hard | Hanging from a tree.
Meatloaf | hard | Look in the small cave area.
Redcurrant | hard | Get on top of the trees at spawn.
Amethyst | difficult | Where else do you think you'd find a gem, genius?
Emerald | difficult | In the cave, being antisocial.
Peapod | difficult | Find a way on top of the greenhouse.
Quiver | difficult | This sure does make me quiver... Look near where one may have passed away.
Elbow | extreme | Got stuck in a chimney (elbow-zo. hah. get it?)
Lancer | extreme | In the cave, chase after that rascal!
Robot Cake | extreme | Where do all robot cakes hide... Under a bridge, of course.
Spider Ball | extreme | Crawling around in the small cave area.
Bolty | unforgiving | Start by finding a weather machine.
Bug Zapper | unforgiving | Start in greenhouse, then look for pesky buzzing sounds.
Butter Churner | unforgiving | One of the houses is locked... perhaps you should find a key?
Iolite | unforgiving | Stuck between a ROCK and a hard place. (Start in Cave)
Asteroid | insane | Look in the cave for an obby. It starts in the upper floor.
Beetroot | insane | Start farming.
Crystal Firey | insane | In the cave. Talk to Emerald to know more.
Dioptase | insane | You can't reach that island. Unless... (Hidden in Cave)
Infinity | insane | Do each obby on the beach, starting with the blue one.
Magney | insane | Upstairs in the cave.
Rainbow Slinky | insane | Find a rainbow rectangle in the Greenhouse.
BFDIA 5b | dreadful | 5b is a game, and this object is under a platform!
Birdie | dreadful | When they talked about canaries in coal mines, I don't think this is what they meant. (Start in Cave)
Calamari Ring | dreadful | Something's off with one of the Lancer rooms...
Clickbait Arrow | dreadful | There's like twenty of them, I'm sure you'll be able to find them!
Peach | dreadful | Start by finding a book in Greenhouse.
Deadly | terrifying | Beware the door in the cave.
Grarblicker | terrifying | Find 5 buttons around the spawn and cave areas. (WARNING: TELEPORTING WILL REMOVE YOUR PROGRESS!!!)
Spinel | terrifying | Because this update didn't have enough gems, we just had to add another! (Start in Cave)
Veterany | terrifying | Get on top of the Starter Place house, then find another realm. Look under the bridges.
2009 Firey | arduous | Embrace your inner retro... Find 6 classic Roblox weapons around the map, then head to Starter Place.
Sausage Roll | arduous | sausage roll sausage roll sausage roll sausage roll sausage roll sausage roll sausage roll sausage roll sausage roll sausage roll sausage roll sausage roll sausage roll sausage roll sausage roll sausage roll sausage roll sausage roll sausage roll sausage roll sausage roll sausage roll sausage roll sausage roll sausage roll sausage roll sausage roll sausage roll sausage roll sausage roll sausage roll sausage roll sausage roll sausage roll (in the Bird of Egypt obby)
Three-Leaf Clover | arduous | Find a set of clovers somewhere, then do 3 obbies.
Up Arrow | arduous | In Deadly's area, look in the opposite direction of where this arrow is pointing.
Oxygen | strenuous | Go where an unusual light shines.
Plastic Sun | strenuous | Start in Greenhouse - check near a lookalike of the object. [ hey a little fun fact! this was gonna be rem! ]
Administratory | remorseless | Get on top of the Starter Place house, then find another realm. Scavenge for buttons.
Bird From Egypt | remorseless | It's time to feel pain. Find the hieroglyphs.
Jade | remorseless | Take a leap of faith in the cave.
Cake's Dad | horrifying | Begin by going to Starter Place, check near the huge tree for a hint. Then, go to Timber Peaks, in search of a key. <b>All of this shall lead you to a perilous paradox.</b>

== EVIL FOREST OBJECTS ==
Evil Firey | insane | it's on the campfire, duh
Evil Book | dreadful | behind a large safe
Evil Gelatin | dreadful | look in the campsite
Evil Jarry | dreadful | find a cabin
Evil Spongy | dreadful | how would evil spongy even move around??
Torn Pillow | dreadful | people have asked me why i added this to the evil forest... and to that i say that pillow is a complete menace.
Evil David | terrifying | ylsuoires wa
Evil Pin | arduous | get trolled!! lol!!!!
Evily | strenuous | the evilest of them all!!!!!

== FROZEN WORLD OBJECTS ==
Frozen Steak | strenuous | jordan what have they DONE to you??? (Made by This_manisnothim)
Octahedron | strenuous | walk around until you see them, i guess
Rosin | strenuous | look on one of those strange structures
Ice Chunk | remorseless | up1nthe5ky
Winterous | remorseless | go to the edges
Freeze Juice | horrifying | complete the obby, then head to where penster lies

== INVERTED OBJECTS ==
pen pog | hard | poggers
Penny | hard | the start of a new journey
Robot Loser | hard | somewhere isolated
VR Headset | hard | put on these glasses and you'll enter the world of the game
ango | difficult | what do you think mangoes are from?
Box | difficult | there is definitely no key under that box
Box of Free Puppies | difficult | they're on sale in the steakhouse, which doesn't make sense now that i'm saying it
Coffin | difficult | classic egyptian stuff
Elevator | difficult | too bad it doesn't work
Folder | difficult | cons of being a folder: naming yourself con
Friesland | difficult | they sure do love their fries... and land (Made by AccountDoesNothing)
Liberty Bell | difficult | who told bell about the US of A
Meester Tweester | difficult | inside the pyramid
Pomegranatey | difficult | get noob!! pomegranate gonna do anything
Red Balloony | difficult | weee
Scarfy | difficult | check behind one of the classic trees (Made by lowk3y_TJ)
Slingshot | difficult | based
Toxic Mushroom | difficult | this guy and toxic bomb would be great pals
Zero Dollar Bill | difficult | it's worth not even a penny
Cube | extreme | cube cube cube cube cube cube cube cube cube cube cube cube cube cube cube cube cube cube cube cube cube cube cube cube cube cube cube cube
Jello | extreme | he works with brain damage
Pink Cary | extreme | NO WAY IT'S PINK CARY HIMSELF!!!
Ribbon | extreme | i'll take my award for best-looking R in this realm
Specimum Sandwich | extreme | all alone up there
Yellow Pancake | extreme | got squished in the pyramid
Backpack | unforgiving | how is this even possible
Gramophone | unforgiving | in the inverted number playground house
Max | unforgiving | i don't have any words
Mouse Trap | unforgiving | jump from a window
Obsidian | unforgiving | i literally dare you to find out where this one is
Pesticide | unforgiving | me when there is a substance used for destroying insects or other organisms harmful to cultivated plants or to animals in my body
Sickle | unforgiving | they're hanging on for dear life
Steel Drum | unforgiving | i promise this will be a very creative description uh uhhh
Stringy | unforgiving | fall down twice, that's all
City of LAy | insane | does this imply that inverted realm is more than a thousand times bigger than the city of LA? and the player too???
Frame | insane | i honestly have no idea what this is supposed to be (hey guys it's me jade it's a keyframe from adobe animate)
Hyper | insane | what the fart is this
Ink | insane | gross
Ottoman | insane | the sick man of the inverted realm
Toothbrush | insane | that is not a genuine smile. they know exactly what they did. (Made by lowk3y_TJ)
Demon Ball | dreadful | AAAAAA SCARY MAN!!!!!!
Gold Block | dreadful | complete a timed obby after finding a button somewhere (Made by 0OFunkyPurple)
Jabuticaba | dreadful | do the gold block obby but uh... you're going the wrong way (Made by lowk3y_TJ)
Piece of Glass | dreadful | look near princess flower (Made by cluxser2)
Princess Flower | dreadful | impressive obby skills!
Toxic Bomb | dreadful | find a message and decode it
[Loading Object] | terrifying | Please wait while we process your chosen object.
Checkered Flag | terrifying | find an invisible platform
Geocache | terrifying | in the inverted jungle
Desert Pillar | arduous | start by exploring in the inverted jungle, then go to the area where toxic bomb is located (Made by 0OFunkyPurple)

== MAGMA CANYON OBJECTS ==
Bababa | normal | i love myself some bababas
Block Party | normal | IT'S HIM!!!!!! (Character is owned by illuminite06)
gas can | normal | I HATE WHEN MY GAS CANS
Spongy's Mother | normal | so... does this make spongezilla spongy's father?
Turkey | normal | Will this realm EVER get any good content? Find out next time on Find the BFB Characters the Totally Real Series that Definitely Exists!
Flour | hard | unrelated but i know what you did 5 minutes ago
Mr. Feet | hard | i hate everything about this
Pizza | hard | after AGES... after objects like pizza jr and cookie pizza... after millions of pizza rcs... WE  GET PIZZA IN GAME AS OBJECT!!!!
Shoe | hard | 1 2 buckle my... wait what is tha
wax slitly weathered cut copper stairs | hard | special thanks to Noobie_Sonic2 for this incredible idea
Meatball | extreme | infinite meatballs
Na | extreme | should i make davidland a realm? hmm, na.
refsbcj | extreme | sfdaasdjojfnjadlcxzqo
Robot Puppet | extreme | how could they do this to my man puppet!!!!
Shrimp Tempura | extreme | tasty
ca2 | insane | i don't know what this means but surely it means something
Cardy | insane | they love cards
Erlenmeyer | insane | oh boy this one sure is so much fun
Dynamite | strenuous | The way you get this one is genuinely deranged I'm sorry (Made by SleepyyXavier)

== MAIN REALM OBJECTS ==
American Flag | effortless | this donut shop is america-certified. LAND OF THE FREEE BABY!!!!!!!! (Hidden in City)
Anchor | effortless | in the water (Hidden in Goiky)
Bacon | effortless | right next to a fire (Hidden in Snowy)
Barbecue Sauce | effortless | look behind gelatin's steakhouse, which for the sake of the game has NOT been remade into gelatin's shadeshouse
Basketball | effortless | seems like someone has been shooting some hoops (Hidden in City)
Bell | effortless | whats at the top? (Hidden in Goiky)
Big Nickel | effortless | he's so big i don't know how you wouldn't find him
Birthday Cake | effortless | happy birthday! (it isn't your birthday) [Hidden in Candyland]
Bomby | effortless | explode! (Hidden at Hotel)
Book | effortless | In the City - where would you be most likely to find an annoying know-it-all?
Burrito | effortless | i've always had a soft spot for burritos (Hidden in Tropical Islands)
Bushy | effortless | haha, nice try! but you arent fooling anyone. (Hidden at Hotel)
Cactus | effortless | they thought they could blend in lol!!! (Hidden in Desert)
Camera | effortless | filmin and stuff (Hidden in City)
Cereal Box | effortless | bet you can't guess where this is oh wow this is so hard
Chalk | effortless | hmmmmm (Hidden in City)
Christmas Tree | effortless | Look near spawn- wait it's not even December WHO ON EARTH PUT UP THEIR CHRISTMAS TREE?!
Clock | effortless | tick... tock... tick... tock... ringalingalingaling (Hidden in Number Playground)
Cream Cookie | effortless | there is a very obvious way up at candyland
Diploma | effortless | congratulations you graduated high school now it's time for your life to turn to hell (Hidden in Classic Roblox)
Eight | effortless | on the top of a hill (Hidden in Number Playground)
Evil Leafy | effortless | look at that forest, lets go in! (Hidden in Goiky)
Fairy Floss | effortless | hmmm i wonder where this one is hmmmmmm
Fanny | effortless | she's somewhere awfully hot
Fifteen | effortless | LEAVE!!!! (Hidden in Floating Island)
Firey | effortless | you seriously need a hint for this?
First Aid Kit | effortless | i don't quite understand why they're at the warehouse of all places
Fish Monster | effortless | look on the beaches
Fishy | effortless | we're surrounding by fish, you know what that means? FISH!!!!!! (Hidden at Hotel)
Five | effortless | hanging out with three (Hidden in Number Playground)
Flower | effortless | look inside that house?
Flower Cake | effortless | OH MY FLOWER CAKE (Hidden in Floating Island)
Flower Jr. | effortless | she's admiring a masterpiece (Hidden in Floating Island)
Fries | effortless | i cant belive he managed to get his own resturant! (Hidden in City)
Fruit Cake | effortless | they're chilling near the hotel
Funny Plant | effortless | Have you accidentally killed a plant and want to revive it? Then why don't you set it on fire? And then freeze it? Let it grow on the sun? Or zap it? Make it a fancy dinner? Or feed it to a fish monster? Or push it off a cliff? Dance on it? Explode it? Vomit on it? Play with it underwater?
Gaty | effortless | wonder where she is being used for? (Hidden in Snowy)
Gelatin | effortless | tbh his resturant is much better then fries' (Hidden in City)
Golf Ball | effortless | sitting down is so nice (Hidden in Goiky)
Grassy | effortless | chillin in the grass (Hidden in Goiky)
Hot Cocoa | effortless | i tried hot cocoa a few months ago i didnt like it. man, these descriptions have devolved into just personal stories haven't they? (Hidden in Snowy)
Ice Woody | effortless | how did they combine the two? (Hidden in Snowy)
Icey | effortless | basically ice cube but a fine lady (Hidden in Snowy)
Jaiden | effortless | woof (Hidden in Hotel)
Leafy | effortless | trees are cool. (Hidden in Goiky)
Lotus Flower | effortless | Placeholder description i'll probably forget to change it but it's funnier like this (Hidden in Jungle)
Marble Bottle | effortless | how joyous (Hidden in Hotel)
Marker | effortless | playin toss the dirt (Hidden at Hotel)
Match | effortless | the freesmart van noooo!! (Hidden in Factory)
Milli | effortless | bark (Hidden in Hotel)
Mortar | effortless | Ever watch Brick and Mortar? (Hidden in Jungle) (Made by ThirteenthJade)
Naily | effortless | dont touch that spike! (Hidden in Snowy)
Noodle Cup | effortless | I am truthfully in tears from this series of events that has caused this exquisite noodle cup to be thrown onto the ground without explicit realization.
PaintyBook | effortless | where i keep my masterpieces (Hidden in Tropical Islands)
Pillow | effortless | sleeping. (Hidden in Goiky)
Pin | effortless | guess what pin? you won a win token! (Hidden in Number Playground)
Pineapple | effortless | who lives in a pineapple under the sea? (Hidden in Fossil Falls)
Pistachio | effortless | it looks like a pear inside an egg (Hidden at Hotel)
PiÂ±ata | effortless | it's on a tree, that's basically all you need to know
Prince Circle | effortless | what did they do to him (Hidden in Tropical Islands)
Pumpkin | effortless | behind a tree (Hidden in Goiky)
Purple Girl with Wind Hair and Angry Eyes | effortless | best character in bfb moment (Hidden in Candyland)
RCTI Cast | effortless | aha yes i know what rcti is it's uhh uhhhhh ermmm uh uhhhh (Hidden at Warehouse)
Robot Teardrop | effortless | being manufactured at the factory
Rusty Coin | effortless | im broke, buy my stuff. (Hidden in Desert)
Sandcastle | effortless | playing in the sand (Hidden in Number Playground)
Saw | effortless | whats she doing cutting that tree? (Hidden in Snowy)
Scissors | effortless | not sure if you can really just cut a tree down like that (Hidden in Floating Island)
Selfie Dog | effortless | what do they like to do? (Hidden in Snowy)
Shopping Cart | effortless | shopping for stuff! (Hidden in City)
Snare Drum | effortless | touch them! (Hidden in Snowy)
Snowman | effortless | come to think of it... how do these snowmen not even melt? (Hidden in Snowy)
Sotp Sign | effortless | JUST STOP IT. (Hidden in City)
Stapy | effortless | hangin out with marker (Hidden at Hotel)
Strawberry | effortless | they're enjoying a nice feast (Hidden in Goiky)
Ten | effortless | jacknjelifys 1 million subscribers! (Hidden in Number Playground)
Tent | effortless | who gave the tent boxing gloves (Hidden in Classic Roblox)
Three | effortless | hanging out with five (Hidden in Number Playground)
Traffic Cone | effortless | these inanimate objects are getting out of hand (Hidden in City)
Tree | effortless | Im a tree, im a tree. (Hidden in Goiky)
Trombone | effortless | right above snare drum (Hidden in Snowy)
Vote | effortless | vote using the square brackets! [C] for Blob (Hidden at Factory)
Water Bottle | effortless | water bottle is here to save the day!! (Hidden at Hotel)
Woody | effortless | where you think he is. (Hidden in Snowy)
X the Arcade Machine | effortless | SPOOOOOKY arcade machine!!! just in time for halloween (Hidden in Warehouse)
Zero | effortless | next to ten
8 Inch Floppy Disk | easy | haha i didnt make it 8 inches what will you do about it (Hidden in Classic Roblox)
Announcer | easy | flying with his ufo! (Hidden in City)
Apple | easy | hey apple! KNIFE!!! oh and this is near spawn
Arron | easy | arron my beloved (Hidden in Classic Roblox)
Atom | easy | it's right there (Hidden in Number Playground)
Avocado | easy | blending in! (Hidden in City)
Baby | easy | WAHHHH!!! WAHHHH!!!!! I NEED MILK!!!!!!!!!!! (Hidden In City)
Banana Apple | easy | sitting on a tree... (Hidden in Goiky)
Barry | easy | ourple (Hidden in Fossil Falls)
Birdhouse | easy | nature is epic.............. (Hidden at Hotel)
Blocky | easy | In an area he probably shouldn't be in. What a delinquent. (Start in Goiky)
Bozo | easy | hiding behind a vase (Hidden in City)
Car Door | easy | good thing you can't thlam your- (Hidden in City)
Clown Car | easy | go ahead, get in the clown car, you know it suits you (Hidden at Warehouse)
Club | easy | (Hidden in Factory)
Conch Shell | easy | for someone in the desert area, they look pretty rad
Cookie | easy | hidden in profiley's room, maybe because they store profiley's passwords. get it?
Crayon | easy | on a piece of paper (Hidden in Number Playground)
Dane | easy | hey (Hidden in City)
Dime | easy | golf ball dropped her dime (Hidden in Goiky)
Discy | easy | perhaps it's a disc to a game?
Donut | easy | being served as food... wuh oh (Hidden in City)
Euro | easy | how much will it cost? not even a euro. (Hidden in Fossil Falls)
Evil Marker | easy | he doesn't want to play toss the dirt anymore (Hidden in Floating Island)
Fire Citrus | easy | HOT HOT HOT!!! (Hidden in Jungle)
Fish | easy | blub blub blub (Hidden in Classic Roblox)
Fork Repellenty | easy | dropped on the floor (Hidden in Factory)
Greeny | easy | ball 2: the sequel (Hidden in Warehouse)
Hole in the Wall | easy | look for, well, a hole in the wall
Jetpacky | easy | In what situation could you POSSIBLY need a jetpack in a Warehouse for? This is the actual hint (Made by DrPepperHeinz)
Konpeito Jar | easy | excuse me, a what jar?? (Hidden in City)
Lamp Post | easy | "i'm seeing double!" that was  their last word (Hidden in City)
Lightning Cherry | easy | hidden on a board
Limbless Pin | easy | How did she manage to get on there without limbs? (Hidden in Floating Island)
Loser | easy | sitting in his throne. (Hidden in City)
Magician Hat | easy | everyone knows the famous spell, "yaba daba doo" (Hidden in Classic Roblox)
Mochi | easy | mochji (Hidden in City)
Needle | easy | needle in a haystack, how original (Hidden in Goiky)
Nickel | easy | on the ground somewhere.
Ninja Woody | easy | The suspiciously Woody shaped hole:
Orb | easy | floating orb, floating island
Ornament | easy | it's an ornament, yep. sorry i dont really have anyrthing to say (Hidden in Snowy)
Pearl | easy | look inside of a clump of cotton candy
Pickle Juice | easy | they really just need a moment to rethink their lifefe decisions (Hidden in Tropical Islands)
Piney | easy | what do you think pinecones are on?
Popcorn | easy | give me some of that popcorn (Hidden in Hotel)
Profiley | easy | pictures be like (Start in Goiky)
Roboty | easy | my brain keeps "resetting"
Ropey | easy | they're such a silly slithering little rope (Hidden in Goiky)
Rose | easy | bumblebees are out! (Hidden in City)
Rubber Spatula | easy | being sad at the death of a group. (Hidden in Goiky)
Sand | easy | behind something in the sand
Sandwich Roll | easy | on top of a giant plant (Hidden in Jungle)
SaulStories | easy | My Name is Saul and THese Are My Sttories. Watch Evan the Wolf! (Made by Meowbah)
Screen Door | easy | look inside the warehouse
Spongy | easy | sitting on the plane! (Hidden in Tropical Islands)
Spunce | easy | what is this thing even supposed to be? (Hidden at Hotel)
Sun Spray | easy | in an area where you need it most (not tropical islands though)
Swing | easy | does this even remotely resemble a swing?? (Hidden in Classic Roblox)
Tape | easy | they're in a "sticky" situation! im not funny (Hidden in City)
Teardrop | easy | something water perhaps.
Tophat | easy | very fancy (Hidden at Factory)
TV | easy | hiding under a flight of stairs
UFO | easy | did you know the population of jupiter is 60,802 (Hidden in Factory)
Wish | easy | get up there and make a wish! (Hidden in City)
Xmas Light | easy | (Hidden in Fossil Falls)
a | moderate | aaaaaaaa (Hidden in Desert)
A Duck | moderate | who doesnt play with them in the bath? (Hidden in Goiky)
Acacia Tree | moderate | literally stuck in a tree (Hidden in Number Playground)
Awesome Diamond | moderate | The more easy objects I add, the easier it gets to reach the 1000 medal, right? This is an actual hint btw
Barf Bag | moderate | Contemplating life: multifaceted in many ways yet following a pattern. Amidst a wave of ingenuity, compassion, creativity, and an ever increasing population of souls destined to part from this mortal plane or live on forever as memories. Life can best be defined as a dance of ideals and limitations. Nobody is perfect; neither you or me or ANYONE in this whole planet can call themselves flawless. While we may fight for our beliefs, it is important to remember that we all share the same basic components and should respect the beliefs of others instead of fighting because of them. Why barf bag of all objects to contain such a description like this? I don't know, I just felt like it. Expect more of these in the future I guess. Since you read all of this, Barf Bag is located on one of the museum's pillars. You'll need to get on top of the Library to reach. (Hidden in City)
Beanie | moderate | look inside of a bush (Hidden in Jungle)
Bermuda | moderate | make sure you don't get sucked in by them (Start in Classic Roblox) (Made by AccountDoesNothing)
Bowl of Petunias | moderate | mmmmm... delicious... you ever just eat a bowl of flowers (Hidden in Tropical Islands)
Canadian Flag | moderate | it still looks better than the canadian flag in r/place (Hidden in Classic Roblox)
Carrot | moderate | CARROT!!! (Hidden in Warehouse)
Charcoal | moderate | in a place full of fire and heat (Hidden in Snowy)
Cheesy Mayo | moderate | it's mayo... but CHEESY OOOokay so now it makes sense why they are right next to a dumpster (Hidden in City)
Chicken Nugget | moderate | do you want free chicken nuggets (Hidden in Classic Roblox. Start at Hotel.)
Clip | moderate | clipped onto a frame (Hidden in Desert)
Cloudy | moderate | Jump on a few platforms (Hidden in Goiky)
Coiny | moderate | the opposite of where nickel was (Hidden in Goiky)
Compass | moderate | Id suggest checking paper, but who knows lol
Computer Mouse | moderate | this one is actually not where you'd expect it to be (Hidden in Classic Roblox)
Cotton Candy | moderate | those are some nice looking cotton candy trees
Cranberry | moderate | i dont like cranberry (Hidden in Hotel)
Crazy Needle | moderate | At the end of the rainbow.
Crumbley | moderate | nice roof (Hidden in Factory)
Dreidel | moderate | they go spin (Hidden in Warehouse)
Duffel Bag | moderate | yeah (Hidden in Fossil Falls)
Electric Guitar | moderate | ah yes the void (Hidden in Floating Island)
Eraser | moderate | he's still climbing that string (Start in Goiky)
Ethernet Splitter | moderate | he's an ethernet splitter while this game is your internet splitter! (Hidden in Factory)
Fall Leafy | moderate | find a way up a tree (Hidden at Hotel)
Firey Plush | moderate | totally not hiding behind a cactus
Foldy | moderate | oh god shes falling! (Hidden at Hotel)
Football Player | moderate | somebody left their helmet somewhere
Four Plush | moderate | why wont people buy him?? (Hidden in City)
Glue | moderate | why would you handstand in glue??? (Hidden in Desert)
Hammer | moderate | do you think the person who invented hammers was eating a ham sandwich at the time? sorry just trying to make a bad joke (Hidden at Hotel)
Happy Birthday Card | moderate | it still isn't your birthday (Hidden in Snowy)
Hot Chocolate | moderate | obviously someone would want this during the cold
Hot Dog | moderate | hidden besides a structure (Hidden at Warehouse)
Isabella | moderate | i don't get it... it's just a purple ball (Hidden in Classic Roblox)
Jacknjellify | moderate | WHAT (Hidden in Floating Island)
Jordan | moderate | inside a restaurant, hmm i wonder which one...
Keytar | moderate | rock away little keyboard guy!!!! (Hidden in Classic Roblox)
King Pen | moderate | you were probably expecting me to make king pen one of the hardest objects in the game, but no all you get is a normal difficulty (Hidden in City)
Kitchen Sink | moderate | look for some bathroom stalls, which is weird since they are a kitchen sink
Leafy Plush | moderate | someone lost their plushie at home
Leek | moderate | behind a tree (Hidden in Floating Island)
Microphone | moderate | mic up (Hidden in Warehouse)
Modern Art | moderate | this and lollipop's scribble are pieces of art (Hidden in Hotel)
Mr. Fish | moderate | fishes... fisHES... FISHESS!!
One | moderate | most forgettable number in bfb. i am writing this two years later to say that this didn't age well (Hidden in Number Playground)
Paint Palette | moderate | it's in something pink..
Pen | moderate | on a table, being used as a regular item.
Pencil | moderate | find a paper on the ground and click on it.
Price Tag | moderate | the roofy roof was a cool roof.
Puppet | moderate | behind a door somewhere
Puzzle Piece | moderate | on a table or a shelf...
Rainbow | moderate | check on the rainbow at floating island
Rainbow Puppy | moderate | yay puppeee (Hidden in Floating Island)
RoboBoi | moderate | put on these glasses, and you'll ent- hey wait didn't i already make that joke? (Hidden in Hotel)
Rutabaga | moderate | (Hidden in Classic Roblox)
Salt Lamp | moderate | salti lampi (Start in Goiky)
Science Book | moderate | wall wraparound moment (Hidden in Floating Island)
Shuriken | moderate | i'm a ninja!! (Hidden in Jungle)
Smokebox | moderate | Click a suspicious button in a place that sells food.
Sock | moderate | all alone under the bed (Hidden in Floating Island)
Space Book | moderate | haha i have no idea what to put here (Hidden at Hotel)
Spray Bottle | moderate | (Start in City)
Steamy | moderate | oh no, a cloudy ripoff!! (Hidden in Goiky)
Sticker | moderate | you'll never be able to beat this one!!! ruahahahahahahaha!!!!!!!!!!!! (Start in Desert) (Made by 0OFunkyPurple)
Sugar Cube | moderate | well, there's only one way on that lollipop
Taco | moderate | reference to bfb 29 (Hidden in Goiky)
Toilet Paper | moderate | they will not know the trauma of being used (Hidden in Number Playground)
VHSy | moderate | go back to the 80's where you belong! (Hidden in City)
Vibe Check X | moderate | looks like you're going to the E.X.I.T. realm jimbo (Hidden in Snowy)
Waffle | moderate | todays menu! waffle..? (Hidden in City)
Wallet | moderate | gee, sure hope no one will steal this wallet in the headquarters! (Hidden in City)
Watermelon Slice | moderate | tree climbing simulator (Hidden in Fossil Falls)
Winner | moderate | somewhere near loser where i wont tell
Yo-Yo | moderate | right next to a mouse hole (Hidden in Factory)
Zipper | moderate | they're so little (Hidden in Classic Roblox)
8-Ball | normal | What is the thing on his head? (say in chat)
9-Ball | normal | near their twin
Amethysty | normal | cool, i guess (Hidden in Tropical Islands)
Awesome Face | normal | not quite epic, but still awesome (Hidden in Jungle)
Baking Soda | normal | how tasty (Made by lowk3y_TJ) (Start in Warehouse)
Ball | normal | looks they got bounced up too high... they landed straight onto a tree! (Hidden in Number Playground)
Balloony | normal | try jumping off of a high building to it (Hidden in City)
Bally | normal | every sport needs a ball! i don't think this is the right type
BFDI Marker | normal | funny how this is the 3rd marker-related object in the game (Hidden in Classic Roblox)
Bitty | normal | what is an area that's very retro-like?
Blender | normal | click a poster that totally isnt about a blender
Bottle | normal | yoo check out that big R! (Hidden in City)
Bracelety | normal | watching ice cube is fun. (Hidden in Snowy)
Butter | normal | This is Butter. From This game. (Hidden in City)
Buzzsaw | normal | It's everyone's favourite object, Bu- hey wait... what are they doing here?! (Hidden in Factory, made by
Car Engine | normal | vroom (Hidden in City)
Cave Drawing | normal | a drawing to be forgotten (Hidden in Factory)
cheese | normal | i should have never put custom avatars into the ultra mega fart donation perks (this is a repeat of fredster's description) (Start in Warehouse)
Chestnut | normal | (Hidden in Fossil Falls)
Chocolate Bar | normal | i'll let you figure this one out on your own
Clover | normal | sticking out of a bush [Hidden at Warehouse]
Cologne | normal | think about it, where are you gonna go when you need to find cologne?
Cookie Pizza | normal | ... maybe it's a good thing they're hidden... (Hidden in Classic Roblox)
Dark Gemstone | normal | chilling at the peak of the fossil falls (Made by 3RR0R_B0I)
Domino | normal | in the yellow face warehouse
Drinky Bird | normal | Hidden in City
Fettuccine | normal | the first floating island update in one million years (Hidden in Floating Island) (Made by lowk3y_TJ)
Firey Jr. | normal | in fire?
Fourteen | normal | they're a little silly (Hidden in Number Playground)
Green Egg | normal | look inside of the jungle
Hexagon | normal | if only hexagon was invented in latin (Hidden in Jungle)
Kabab | normal | look beneath fries' table (Hidden in City)
Lemonade | normal | this lemonade is minging (Hidden in Desert)
Lightning | normal | up in the sky (Hidden in Goiky)
Lollipop | normal | that lollipop is tasty!
Meat Cube | normal | wall flicking, how fun! (Hidden in Warehouse)
Metal Scrap | normal | more like uhh... metal CRAP. i am a little #edgy (Made by FunkyPurple) (Start in Floating Island)
Milkshake | normal | (Start  in Candyland)
Nine and Six Combined | normal | jacknjellify knew exactly what they were doing (Hidden in Number Playground)
Pasty | normal | is this supposed to be pasta (Hidden in Jungle)
Plump Dog | normal | plump th dog (Hidden in Desert)
Pop Tart | normal | just being a pop tart (Start in Candyland)  (Made by cluxser2)
Purple Dragon | normal | that foolish dragon (Hidden in Fossil Falls... you can almost definitely see it.)
Robot Flower | normal | behind something, i aint telling you what. (Hidden in Factory)
Rocky | normal | Can someone PLEASE help him get out!? He's being a pest. (Hidden in City)
Ruby | normal | check inside the factory area
S'mores Milkshake | normal | smores are yummy and milkshakes are yummy, so why not? (Hidden in Classic Roblox)
Seaweed | normal | find a group of seaweed on the corners of the map (Made by Ohlegess)
Slug | normal | MAKE IT STOP (Hidden in Desert)
Snake | normal | be careful of the lurking jungle snakes
Taco Guy | normal | it's not taco, it's taco guy, get it right (Hidden in Jungle)
Triangle | normal | why are they so mad what went wrong (Hidden in Classic Roblox)
USB | normal | look behind a tree, not just any tree though (Hidden in City)
V | normal | ectored (Hidden in Number Playground)
Banana | intermediate | same deal as pasty (Hidden in Jungle)
Bird | intermediate | hoot hoot tweet tweet (Hidden in Classic Roblox)
Blanket | intermediate | they going zzzzzzzz (Hidden in Goiky)
Blue Lion | intermediate | first yellow leopard, then red elephant, and now THIS? (Hidden in Floating Island)
Blue Shiny Coiny | intermediate | i've got my own style! (Start in Goiky)
Boom Mic | intermediate | (Start  in Candyland)
Bready | intermediate | me when the uhhh errr uhhh ummm bread (Hidden in City)
Cartridge | intermediate | find a cave
Chanterelle | intermediate | ah yes the void (Hidden in Floating Island)
Chef David | intermediate | aw seriously? another david? (Hidden in Candyland)
Crate | intermediate | what else is there that contains items? (Hidden in Desert)
David | intermediate | noclip into something unexpected
Davidworm | intermediate | i wish i lived in a timeline where this didnt exist (Hidden at Hotel)
Dollar Bill | intermediate | look inside of a bush (Hidden at Warehouse)
Flower Crown | intermediate | i don't know what to make the description, but to be fair i never do (Hidden in Jungle)
Fortune Cookie | intermediate | someone dropped them on the floor (Hidden in City)
Four and X | intermediate | it isn't a badge hunt game without a cliche teamwork one (Hidden in Number Playground)
Genderfluid Book | intermediate | should have made this during pride month darn (Hidden in City)
Good Rhombicosidodecahedron | intermediate | he wants to be just like his father! [start in warehouse]
Green Rocky | intermediate | green rocky!!! do the thing!!! HOW COULD THIS HAPPEN?!?!? (Hidden in Jungle)
Idoit | intermediate | idoit will never be forgotten (Hidden in Goiky)
Knifeball | intermediate | they give out terrible advice alphabetically (Hidden in Warehouse)
Lever | intermediate | complete an obby at the factory
Lip Gloss | intermediate | check behind vases (Hidden in Hotel)
Mail | intermediate | you've got mail (Hidden in Classic Roblox)
Meteor | intermediate | OH GOD WE'RE ALL GOING TO DIE!!!!!!!!!!!!! (Hidden in Classic Roblox)
Miku | intermediate | klaptai would be proud
Milli Book | intermediate |  (Start in Candyland)
Pea | intermediate | did you eat your peas today (Hidden in Classic Roblox)
Pixelated Heart | intermediate | i wonder what that heart is doing (Hidden at Hotel)
Remote | intermediate | that remote looks cool.
Sand Jar | intermediate | they definitely hate mondays (Hidden in Desert)
SD Card | intermediate | find an invisible path near planks of wood (Hidden at Factory)
Seven | intermediate | not what you think it is... (Hidden in Number Playground... or is it?)
Six | intermediate | they're alone in the sky (Start in Goiky)
Spoony | intermediate | why would you use them anyway? (Hidden in City)
Succulent | intermediate | THIS IS NOT HOW GRAVITY WORKS I THINK (Hidden in Floating Island)
Symbol | intermediate | this is the symbol of crying because you have to do spongezilla legit
Tabley | intermediate | Get up the difficulty chart.
Texas Donut | intermediate | something is off about where succulent is... (Hidden in Floating Island)
Well | intermediate | oh well (Hidden in Tropical Islands)
Air | hard | everyone give a round of applause to our 5th nonexisty (Hidden at Hotel)
Among Us X | hard | HI GELATIN (Start in City)
Barf Molecule | hard | look in the city... something yellow
Blob | hard | you need to vote for them, but how?
Bowling Ball | hard | look inside seven's quiz room
Bright Radiant Plasma Needle | hard | Needle Family Reunion!
Calculator | hard | i hope you're good at square root
Candy | hard | somewhere with a lot of candy
Candy Corn | hard | i am the ONLY ONE who actually likes candy corn???? (Start in Candyland)
Cary | hard | NO WAY IT'S CARY HIMSELF!!! (Hidden in Classic Roblox)
Cat | hard | taking stuck on a tree to the next level (Start in City)
Chocolate Chip | hard | find a code at candyland
Chocolate Pop | hard | this is literally just cake pop 2 (Hidden in Candyland)
Coffee Bean | hard | (Hidden in Fossil Falls)
Diskette | hard | gotta risk it for the diskette (Hidden in Factory)
Eggy | hard | behind a shelf in the city
English Cream Cake | hard | on top of a fridge somewhere (Start in City)
Fire Spatula | hard | remember, x marks the spot!
Fossil | hard | click on a fossil somewhere...
Fridge | hard | that's it? IT'S JUST A FRIDGE?? (Start in City)
Fronk | hard | "I'm fronk! FTBC? UGH. More like Find the BUH. Winter disapproved." (Look below the water...)
Gear | hard | this definitely grinds my gears (Hidden in City)
Giant Tree | hard | it's a giant tree (Start at Warehouse)
Gifty | hard | find 5 gifts around the place and then find a bunch of gifts laying around at factory
Halporhini Cube | hard | that's a weird looking cube (Start in Warehouse)
Ice Cube | hard | ice?
Irony | hard | insert joke about irony here (Hidden at Factory)
Jawbreaker | hard | find a way onto a lollipop (Hidden in Candyland)
Liy | hard | find a hidden light switch somewhere
Mardi Gras Bead | hard | (Hidden in Fossil Falls)
Marimo Ball | hard | talk about camo... (Hidden in Goiky)
Mechanical Pencil | hard | used for mechanical reasons (Start in Calculator's room)
Minty | hard | people who actually like mint are crazy and you should stay as far away from them as possible (Hidden at Hotel)
Nine | hard | oh no, he lost his skateboard! find it and click it!
Palmy | hard | underneath the map lies a upside down tree...
Peanut Butter | hard | what? only 96 chocolate balls?? OUTRAGEOUS!! (Hidden at Hotel. Find four chocolate balls around the map)
Pebble | hard | rocks are merely big pebbles (Start in Goiky)
Purple Face | hard | you do not know anything, you're... PURPLE!!! (Start in City)
Rollarskate | hard | A pair of skates so cool that they don't even follow the laws of physics. (Hidden at Warehouse)
Slide Man | hard | look at em go (Hidden in Jungle)
Spark Plug | hard | find a way onto a roof (Hidden in Classic Roblox, but start at the Hotel.)
Sundae | hard | nice and fresh, i sure hope it doesn't fall over (Hidden in Candyland)
Tablety | hard | find a window on the headquarters that are different from the rest
Titanium Knife | hard | start by finding a button in desert.
Tri-Tri | hard | there's something off with a nose somewhere... perhaps it's frostbite?
Tungsten | hard | she up all night grindin' my gears
Two Halves | hard | awh
Vomit Drop | hard | look underneath a platform in a certain factory
Yellow Face | hard | what do you use to film? (Start in City)
Battery | difficult | think about it, what item needs you to put a battery in?
Black Marker | difficult | how does an object simply noclip through reality? (Start in Spawn)
Blue Needle | difficult | Those legs explain some things... Hidden with her peers, obviously.
Blue Square | difficult | look in somewhere purple (Start in City)
Bluecky | difficult | i'm BLUE!!!!! DABABDEE!!!!!!! DABADI!!!!!! (Start in Fossil Falls)
Boaty | difficult | this is a VERY clutch jump (Hidden in Tropical Islands)
Box Fan | difficult | inside of a factory room
Clapboard | difficult | find a way out of yellow face's room, maybe a hidden door?
De Stijl | difficult | definitely the artwork of all time (Hidden in Classic Roblox)
Dora | difficult | find a way to noclip in the backrooms itself
Em | difficult | oh em gee (Start in Fossil Falls)
Fire | difficult | don't let them get anywhere near that world ending bomb... oh for petals sake (Hidden in Warehouse)
Fish Bowl | difficult | check under the map
Four | difficult | outside of something. (Start in Goiky)
Function | difficult | i am dearly sorry for where i put this one (Hidden at Warehouse)
Hailairhous | difficult | asdpisdau9u1jxjzkjf'sdaidps (Hidden in Snowy)
Headphones | difficult | someone threw away their headphones somewhere (Hidden near Tennis Ball)
Image | difficult | find a way into the factory room
Jingle Bell | difficult | jingle jingle jingle (Start in Goiky)
Junior | difficult | david jr!!!!! real!!!! (Start in Goiky)
Lasagna | difficult | box fan just needs some lasagna (Hidden in Factory)
Lily | difficult | where am i!! (Start in City)
Long Marker | difficult | uhhhhhhhhhh (Start in Goiky)
Metal Leafy | difficult | do an obby under the map.
One Way Sign | difficult | i have nothing for this one i genuinely don't (Hidden in Jungle)
Orange Cat | difficult | what a silly little guy (Hidden in Tropical Islands)
Paper | difficult | look around the hall of fame
Pastel Feather | difficult | how silly (Start in Goiky)
PDA | difficult | you have to click something on a wall
Portable Music Player | difficult | get into purple face's mouth
Puffball | difficult | i believe i (can't) fly (Hidden in Goiky)
Santa Hat | difficult | get to santa hat's sleigh!
Shampoo | difficult | maybe try checking seven's area?
Snowball | difficult | uh oh ball obby
Swiss Roll | difficult | three words: tap to move
Tennis Ball | difficult | there is two parts of a code in City and Snow, make sure to put /e before it!
Tennis Ball Speaker Box | difficult | in tennis ball's garbage pile
The First Frame | difficult | yeah, i know, she was so surprised (Start in Goiky)
Touch-Tone | difficult | real!!! (Start in Goiky)
Tropical Virtual Pet Lizard | difficult | oddly specific but ok (Hidden in Tropical Islands)
Wet Clay | difficult | poor clay never saw it coming (Start in Fossil Falls)
Win Token | difficult | this object is SLOP. (Start in Tropical Islands)
World Map | difficult | you might randomly find them while looking down
Yellow Watermelon | difficult | ceritifed materwelon (Hidden in Jungle)
Yoyle Pie | difficult | a delicate meal enjoyed by everyone... except king cake (Start in Goiky)
YSA Status | difficult | look, ok. if you had to add the 1025th character to a game about a show that only has about 150 relevant characters, what would YOU add?
Air Freshener | extreme | they just want to freshen the air... or the void i guess (Hidden in Candyland)
Beach Ball | extreme | oh no, they're drowning!! press three buttons in each area to create a path: tropical islands, number playground, and candyland
Bead | extreme | that_beadyboi (Hidden in City)
Bomby Plush | extreme | on the ceiling (Hidden in City)
Cake Pop | extreme | what a lovely day innit bruv (Start in Candyland)
Comet | extreme | push a boulder to a certain button, then return to the desert area
Controller | extreme | uhhhh cheat the obby (its a /e code)
CRT | extreme | No description
Dog Collar | extreme | they're stuck in the CRC
Earth | extreme | clip inside the interior of a building
Evil Bubble | extreme | i'm glad that i get to do a key door puzzle. AGAIN. (Hidden in Desert, find a key)
Falafel | extreme | something seems off about gelatin's menu...
Gashapon Capsule | extreme | im (Hidden in Snowy)
Green Square | extreme | (Hidden in Jungle)
Homeless Spooky | extreme | spooky needs money help him (Start in Hotel, find a hat)(Made by @Just_Summa)
Income Tax Return Document | extreme | just thinking about their life decisions... (Start in City)
Irregular Polygon | extreme | is it REALLY a polygon if it has circular sides? (Hidden near... something red, in the sky) (Made by NTailsGoBrrrrr)
Lava Ball | extreme | >:) (Start in Desert)
Lego Brick | extreme | don't step on it please i'm begging you (Hidden in Desert)
Microwave | extreme | chilling at the worst possible spot (Start in City)
Mocha | extreme | do i need it? (Start in Candyland)
Omega | extreme | omaga
Pie | extreme | mari? oh... (Start in Candyland)
Pixely | extreme | don't worry it's not actually the size of a pixel (Hidden in Jungle)
Poker Chip | extreme | something red... (Hidden in City)
Puffball Speaker Box | extreme | it's cake at STAAAAAAAAAAAAA (Start in Candyland)
Raising Cane's Cup | extreme | who up raising they canes rn (Made by lowk3y_TJ) (Start in Candyland)
Red Mushroom | extreme |  (Start in Candyland)
Revolver | extreme | high from the ground somewhere, you will need some people to help
Shoiyta | extreme | I.. I'M SHOIYTA!!!!! i know this is from greeny's grand game but i just couldn't resist it (Hidden in Desert)
Steamboat Hat | extreme | one must imagine steamboat hat happy (Start in Factory)
Strudel | extreme | there is so little detail on this that it doesn't even resemble a strudel anymore (Start in Candyland)
Taco With Tophat | extreme | what a fancy taco (Hidden in Jungle)
Tune | extreme | find a pair of headphones in tennis ball's room
Uni | extreme | they gave up pushing that boulder after so many years (Hidden at Factory... sorta)
Vanilla Milkshake | extreme | i don't care what anyone has to say, vanilla is the goat (Start in Candyland)
Weird Speaker Box | extreme | walk a long way after announcer (Start in City)
Beanbag | unforgiving | comfiest chair in the world (Start in City)
Cake | unforgiving | the cake is a lie (Start in PDA's Room)
Credit Card | unforgiving | Okay, so if you just tell me your credit card number as well as the three little numbers on the back, you can get this object! Deal? (Start in City)
Demonic Painting | unforgiving | what a joyous painting! (Made by Ohlegess) (Start in Goiky)
Drilly | unforgiving | clip out of bounds then clip out of the clipped bounds... clipception
Earphone Shotgun | unforgiving | corner clip on a suspicious wall (press F)
Exploding David | unforgiving | ruh roh.. who gave david a bomb head (Start in City)
Feet | unforgiving | find a controller in the headquarters
Firey Speaker Box | unforgiving | gotta complete an obby (Start in Desert)
Gumbally | unforgiving | someone put their gum under the table.... of course (Start in Goiky)
Lampy | unforgiving | don't ask why this one is insane difficulty (Start in Goiky)
Leafy Jr. | unforgiving | if there is a leafy jr. then what would evil leafy jr. look like? (Hidden in Jungle)
Monarch | unforgiving | why is it called a monarch why why wh (Start in Goiky)
Onigiri | unforgiving | don't even think about pushing that button... (Start in City)
Ordinary Banana... | unforgiving | what time is it??? find three buttons in floating island, classic roblox, and somewhere else.. (Made by This_manisnothim)
Peanut | unforgiving | look inside of the jungle trees
Quartz | unforgiving | find a key to a crate
Roboty-y | unforgiving | i think it should be clear where this one is located
Spike Ball | unforgiving | don't like moving forests? then maybe you'd like this (Start in Goiky)
Stool | unforgiving | look around in classic roblox
Sun | unforgiving | wait.. the SUN?!?!? (Hidden in Goiky)
Thirteen | unforgiving | not gonna say where, but its near something purple
Tombstone | unforgiving | rip (Hidden in Fossil Falls)
Yellow Leopard | unforgiving | heck (Hidden in Desert)
Zombified Barf Bag | unforgiving | find a wrench to unlock access to the sewers
Black Hole | insane | There are pieces of code scattered throughout Spawn and Snow areas, find all 5 pieces and then go to Factory area.
Bubble | insane | oh lord why do i love invisible platforms so much. (Start in City)
Buh | insane | hey guys, it's me, buh! and welcome... to the buh-ly object show! (Start in Warehouse)
Feather | insane | he's way too far in the sky for you to reach... perhaps if you had a friend to help?
Flower Speaker Box | insane | shes near firey speaker box
Four Colored Gelatin | insane | GELATIN WHAT DID THEY DO TO YOU (Start in Goiky)
Frozen Yogurt | insane | Start in Candyland
Geode | insane | Just another hump of trash in the sewers.(Start at Hotel)
Gingerbread Man | insane | do you know the muffin man (Start in Number Playground)
Laser Pointer | insane | not exactly the most ideal place to be (Start in City)
Pride Cat Firey | insane | rawr nya X3 (Start in City)
Shinyleaf | insane | oooo shiny (Start in Candyland)
Sippy | insane | hmmmmmmmmmmmmmmmmmmmmmmmmm (Start in City)
THE GET AWAY FROM ME BUTTON!!!!!!! | insane | looks like two dropped his button somewhere
Trash Can | insane | heya mmm no hints!
Two | insane | invisible platforms are cool. (Start in Goiky)
X | insane | kick down something... (Start in Goiky)
Bandana | dreadful | find a pathway that leads somewhere outside (Start in City)
d | dreadful | hidden somewhere that contains a d (Start in Tennis Ball's room)
Immortality Thing | dreadful | IMMORTALITY!!!!!!! (Start at Hotel) (Made by KingOfChomiks90)
Jellybean Jar | dreadful | that's a nice jar of jellybeans there (Made by lowk3y_TJ) (Hidden in Candyland)
Oodle | dreadful | something lies deeper within the EXIT...
Sad Cloudy | dreadful | find yourself in an unfortunate predicament after trying to cheese a certain character
Safe | dreadful | he's safe to where no one can find him... right? (Start in City)
Torch | dreadful | it's torc (Start at Factory)
Troll Face | dreadful | problem? (Start at Factory, get trolled.)
Chicken Nuggets | terrifying | find a way to destroy a barrel at desert. anything for the nuggets!!!
Evidence Bag | terrifying | to see this description first you must find evidence of DEEZ NU- (Start in Factory)
Quereltrajankyn | terrifying | what in the world is that (Made by KingOfChomiks90), (Start in spawn, maybe look up?)
ReplicatedStorage | terrifying | start in classic paradise. find a teleporter. (Made by ThirteenthJade)
Sharp | terrifying | honey, you okay? you'VE haRd1y t0ucHed YOur !(%!^*@!^! (Start  in Candyland, drop down)
Slime Flashlight | terrifying | press a button in a mechanical area to drain out some slime (Made by KingOfChomiks90)
This is Sparta-Y | terrifying | ...madness? (Start in Desert)
Alien | arduous | find 8 buttons scattered around the entire overworld, no hints!
Boblob | arduous | start by looking near black hole
Burger | arduous | MUST.... OBTAIN.... THE BURGER!!!!!!!! (Start in the Fourest)
Filler | arduous | we love filler objects here! also i'm not giving you a hint.
Nanoboty | arduous | want to do some math? no? well too bad!
Nonexisty | arduous | up in the sky?
Studio | arduous | start by finding a QR code on the main map, you must have roblox studio to get this one! (Made by NTailsGoBrrrrr)
Throne | arduous | near the FORBIDDEN ORB.
Tiddles | arduous | yellowstickmanyt killed his pet fish tiddles, by throwing him out a window. now he's a cat's lunch!
Ulm | arduous | look near where fedora is
Brainy | strenuous | you need a BIG BRAIN to understand this one. (Hidden in Hall of Fame, but start in Midnight Rooftops. Then, go to the park behind City and insert the correct color combination.)
Cauldron | strenuous | find three potions to finish off the cauldron in the jungle. (Made by Just_Summa)
Evry Charecter Fused | strenuous | sometimes, i wonder, what is the point of making this game? after all, it's not like in the future this game will be relevant, and besides, there's going to be an end to this game sometime. so what's the point? i could go on and on about why i think it's pointless to work on this game, but it isn't worth it. i guess, i think it's my passion project, i wanna do good, y'know? spooky and funky don't necessarily update this game often, and i feel like... without me, the game wouldn't be where it is today, not to brag though. i mean, we're almost to 1000 objects, and it MIGHT be 1000 objects depending on when you're reading this.
Fedora | strenuous | ycjvv??? hkpf c vgzv kp urcyp, crrna ucog ekrjgt
Glitchy | strenuous | YOU SHOULDN'T BE HERE
Hornbox | strenuous | the hero that we didn't deserve but needed (Start in Tennis Ball's room)
King Skull | strenuous | find 14 pieces of code around the entire map, in red text
Poison Cake | strenuous | aka "Poise" (Located in Candyland)
Transmitter | strenuous | beep beep beep bep bep bep bop bep bep bep beep beep (Start near Roboty)
ARG Television | remorseless | start in firey speakerbox's area
Chartreuse | remorseless | start in the throne room and find a way upwards
Front Facing Marker | remorseless | the method to get this is a complete secret. all i'll tell you is that you should try searching for something...
Remote Event | remorseless | they look like they would get along so well! (Start in the Fourest)
SilvaGunner | remorseless | GRAND DAD?!? (Start in Goiky)
Storm Ball | remorseless | The eye of the storm. (Hidden in Factory, find four buttons.)
Starwalker | horrifying | i am the original               starwalker
Wand | horrifying | the only way to get wand is by asking a certain object... perhaps a skull?
EVERYTHING | IMPOSSIBLE | woah it's the everything chomik ripoff who could forget
Hypostasis | IMPOSSIBLE | Hypostasis is the only being capable of nullifying the mere crystallization of the universe. Start in Frozen World, a badge description may help you.
Great Rhombicosidodecahedron |  | Is this the real life?
Bronze Medal | medal | ^^
Diamond Medal | medal | ^^
Gold Medal | medal | ^^
Silver Medal | medal | ^^
Void Medal | medal | ^^

== MIDNIGHT ROOFTOPS OBJECTS ==
Cupcake | hard | i was just coming to pick up a human
Cursor | hard | clickity click
Pancakes | hard | on a balcony of a hotel
Robot Tennis Ball | hard | look inside of grillby's
Sans | hard | SANDS UNDER TALE ?!?!?!?!?!
Thready | hard | i don't know what to put so here's random keyboard mashing pisadhspoadliyqp9ijcxzknawletyhiado
Tomato | hard | i like tomato uhhhh yeah
Dango | extreme | they're on a crane
Glitter Bottle | extreme | i hate glitter it gets all over me
Hot Sauce | extreme | get to a staircase
Ice Cream Cone | extreme | nothing better than a tasty cone of ice cream
Line Coin | extreme | get to the top of a roof
Little Baby Pizza | extreme | baby
Magnet | extreme | unlike magnet i am unattra
PB&J Sandwich | extreme | https://www.youtube.com/watch?v=I92TZOD560E
Spray Can | extreme | spray can is so silly
Vomit | extreme | gross
Bread Coiny | insane | the real bread coiny!!!
Burger Blanket | insane | find an almost invisible pathway
Goldy | insane | jump onto a window
Impostory | insane | flam when he realizes i FINALLY ADDED IMPOSTORY!!!!!!!!
Inverted Cursor | insane | do the same thing as cursor, but inverted
Milky | insane | look in lower parts of the map
Not Canon | insane | use the cannon! or, well... not cannon
Rainbow Cloudy | insane | cloudy tasted the rainbow
SimOndoMino | insane | the originally name got filtered but this is good right?????? roblox please dont ki
Starie | insane | look on the highest building
W | insane | this is such a W moment
cool ice cube | terrifying | SNAP OUT OF IT ICE CUBE!!! you're stuck having reused lines
Cremini | terrifying | mushed room
Electronic Game | terrifying | get to the furthest point away from the map
Every Character Fused | terrifying | occasionally, I find myself in a contemplative state, ruminating upon the underlying purpose and significance of undertaking the development of this particular game. it raises a fundamental question: what is the rationale for investing time and energy into the creation of this gaming endeavor? after all, it appears improbable that this game will retain any substantial relevance in the forthcoming years. furthermore, one must not disregard the inescapable reality that every game, no matter how compelling or captivating, eventually reaches its culmination, and thus, there looms an impending terminus for this game. in light of these contemplations, I am led to ponder, what exactly is the intrinsic value in expending my efforts on this venture? the temptation to embark on a protracted discourse regarding the futility of laboring on this game is palpable, yet I am inclined to demur, for such a discourse, it appears, would be an exercise in futility itself. It is my supposition that this project occupies a unique place in my heart, an endeavor in which I aspire to manifest my creative fervor and enthusiasm, driven by an innate desire to make a positive impact and bring forth something meaningful. it is true that the developers known as "Spooky" and "Funky" do not exhibit a frequent propensity for updating this game, which leads me to ponder the extent of my own contributions. without undue hubris, I dare say that the current state of the game, teetering on the brink of reaching a landmark of a thousand objects, can, to a certain extent, be attributed to my dedication and involvement. it should be noted, though, that the precise number of objects may indeed have already achieved the coveted one thousand, or it may remain tantalizingly close, contingent upon the point in time at which you peruse this composition.
Radio | terrifying | Look under a roof. [Made by @Clownfish4172]
Your Mom | terrifying | yo mama so skibidi among us rizz in ohio
Bandy | strenuous | get the key to the crane
blocky on toilet | strenuous | 
Rock | strenuous | rock. this is a rock
Singapore Map | strenuous | oh boy would you look at that it's another button hunt!!! how fun and exciting!!!!!
Aurora Borealis | remorseless | find four pieces of code in this realm, timber tops, classic paradise, and yoyleland. they're all at the highest points of the realms.
BFB 1-29 Thumbnail Fusion | remorseless | AAAA
Corrupted Firey | remorseless | start by finding a glitchy particle, good luck.
USB Drive | remorseless | the highest point of the map. it won't be easy getting up there!

== SAKURA SERENITY OBJECTS ==
Bonsai | hard | this does not resemble a bonsai in the slightest
Bugspray | hard | there are bugs all over them
Grapefruit | hard | what a peculiar fruit this is
k | hard | this is truly a k moment
Planter | hard | check inside of one of the houses
Robot Saw | hard | wouldn't a robot saw just be a chainsaw?
Autumn Leaf | extreme | one of these trees is off...
Bamboo | extreme | look in a bush
Bean Can | extreme | BEANS!!!!!!!
Butters | extreme | delicious (Made by Just_Summa)
Horn | extreme | they're standing on a paifang
Locket | extreme | climb onto a spike
Snickerdoodle | extreme | wait... this is a REAL thing???
Taiyaki | extreme | on a tree
Chocolate Circle | insane | find a way onto one of the bigger structures
Davidy | insane | first roboty-y, now this???
Humorous Hummus | insane | quite humorous indeed
Plant | insane | why are there two plants in the same realm??
Red Leaf | insane | don't worry it isn't evil leafy.. i think
Spikey | insane | look for a hole.. (Made by Fireballz_37)
Non-Slip Shoes so Ha | terrifying | true fashion
oMg | terrifying | yep, that sure is a thing
Red crayon who is also blue but probably isn't green | terrifying | you heard the name (find five pieces of codes around the map)
Wildy | terrifying | ooooooooooooo swwwwirllllyyyy
? | strenuous | ?
Moon | remorseless | find a way to make it become midnight..

== TIMBER PEAKS OBJECTS ==
Peanut Butter Jar | difficult | hey that's weird, do i taste peanut butter?
S'mores | difficult | i guess you could say you guys want S'MORE objects!!!!... this is why i don't make puns
Vasey | difficult | yeah, that sure is a vase
Wasabi Chips | difficult | wasabi does not approve of these chips
Biscuit | extreme | oh, biscuits...
Cough Drop | extreme | cough... cough...
Dough | extreme | dough... dough...
Algodoo Marble | unforgiving | it's behind a crate
Chips | unforgiving | you may find yourself somewhere unexpected...
Frog | unforgiving | i had every excuse in the world to make this about frog jumping but i didn't, are you guys happy?
Yoyle Spoon | unforgiving | no, please erase this from my memory
Mous.V | insane | it's in plain sight, but there's no way to reach it...
Square Root | insane | beneath a platform
Stump | insane | get to the top of the mountain
Thermometer | insane | man, it's hot up here! wait, that doesn't even make any sense...
Vinyl Record | insane | the viewing of this record is prohibited
Candle | dreadful | look for a faint light
Cheeseburger | dreadful | i wonder how you could get into that barn at spawn?
Spammy | dreadful | they're IN YOUR WALLS.
Network Cable Tester | terrifying | NCCNNCNNNCCNCCCCNCCCNCCCNCCNCCCN
Dot | arduous | .
Nutty | arduous | NUTTY!!!!!!!!!!! nutty nutty nutty nutty nutty nutty nutty nutty nutty
PUMPKIN 2.0 | arduous | Find a mechanical pumpkin somewhere.
Virus | arduous | start in the basement, you'll be able to find something important there.

== YOYLEFACTORY OBJECTS ==
Coolboy | extreme | only 0.01% of people can find him
Elephant | extreme | someone has GOT to address this
FRIENDY+ | extreme | wow he's such a good friend i dont know im really trying with these descriptions okay
Mattress | extreme | they're sleeping somewhere...
Phantastrophy | extreme | the fog is coming the fog is coming the fog is coming the fog is coming the fog is coming the fog is coming the fog is coming the fog is coming
Ace of Clubs | unforgiving | do you think this card likes to groove? (Made by AccountDoesNothing)
Base Charger | unforgiving | you need to charge your mental capacity
Coffee Mug | unforgiving | tea is better
Delicious Fruit | unforgiving | mmm..... delicious.... (Made by AccountDoesNothing)
Diamond | unforgiving | must suck having no limbs... and not being a circle
Four's Uncle Craig | unforgiving | hey craig
Paint Bucket | unforgiving | he's been up to some mischief
Seedling | unforgiving | there's a seed growing in a box
Teabag | unforgiving | bell 2
Text Message | unforgiving | did you get your bogos binted? wait what
Watermelon | unforgiving | look below
Block of Glass | insane | SHATTER SOUND
Electrostatic | insane | find a way to destroy something suspicious. (Made by Cadalac8999)
Glowstick | insane | find a strange light source
Hanheld | insane | abandonment.
Juice Box | insane | take a sip
Maroon Ball | insane | wrong colored ball try again
MousePad | insane | hint: it's NOT at a computer
owoball | insane | i regret nothing
Piano | insane | who is out here playing the piano
Popsicle | insane | a snowball in july?!
Pugsley | insane | dont be fooled, they have 72 charges of murder in the 1st degree
Rubber Ball | insane | find a small button on top of a cog (Made by 0OFunkyPurple)
Stickynotes | insane | one of the last few living things in the abandoned half of the facility..
Trashbag | insane | find a pack of trashbags laying around which are... weirdly small. (Made by NTailsGoBrrrrr)
Aura Sphere | dreadful | it looks like it could be an interdimensional portal that teleported an airline on two pieces of camera footage from 2014
Candy Wrapper | dreadful | i love making normal looking objects absurd difficulties (Made by lowk3y_TJ)
DUMMY3 | dreadful | look for z-fighting
Graphics Card | dreadful | to the 2% of people who actually play ftbc on a computer, this is a certified hood classic
Leafmote | dreadful | who recommended this and why did you recommend it
Lithium | dreadful | find lithium bars
MissingYes | dreadful | what did you do to the yes
Mouse Guy | dreadful | this description is pretty... CHEESY!!!!!! LOL!!!!! hlep me pl
Raisin | dreadful | this is grape's dying grandfather
Spatula | dreadful | find a burger, then find a grill (Made by NTailsGoBrrrr)
Stylus | dreadful | i think we have too many variations of a pen
White Board | dreadful | there is a secretive room in the factory...
Wizard Hat | dreadful | you're a wizard now
-8 Ball | terrifying | start where electrostatic is (Made by NTailsGoBrrrrr)
Among Us Four | terrifying | stuck in the vents for the rest of eternity
Button | terrifying | use shiftlock near a large cog (Made by lowk3y_TJ)
Gaming Controller | terrifying | click the power button of a computer that is acting strange...
Missing Texture Block | terrifying | it can't be an ftbc realm without an object that requires clipping out of bounds
RAM Chip | terrifying | look underneath a platform
Ampersand | arduous | don't ask how the algebraliens are able to teleport to different realms, it just happens (Made by lowk3y_TJ)
Font | arduous | font
Gaming Device | arduous | find 10 buttons around the factory, then return to a doorway
Blue Screen of Death | strenuous | YOUR PC RAN INTO AN ERROR AND NEEDS TO RESTART. RESTART. RESTART. RESTART. RESTART. RESTART. (Made by NTailsGoBrrrrr)
Ground | strenuous | this is the face of someone who has seen it all
Money Bag | strenuous | start by finding a broom. sweep up some unneeded stuff. (Made by This_manisnothim)

== YOYLELAND OBJECTS ==
Boombox | effortless | buy our new leafy detector
Eyes in the Dark | effortless | ooo spoopy eyes
Hand-Powered Recovery Center | effortless | this isn't really an animate object but okay
Ice Cream | effortless | lick lick
Ice Cube Jr. | effortless | making the water cooler
Knife | effortless | hiding in a bush... i think?
Long Pencil | effortless | why did i add this? because i can
Orange | effortless | hmm i dont know about you guys but i dont think he appreciates classification gasconading
Grape | easy | In the top left corner of the map.
Lewis | easy | i ain't giving up.. I AIN'T GIVING UP!!!! there's cake at stake lewis!!!
Lollipop Plush | easy | hidden in the allyways of yoylecity
Pandora Book | easy | Hiding behind a building somewhere...
Swappy | easy | i have no idea what to put here (pun intended)
Unpainted Gaty | easy | this is gaty, but unpainted... yeah idk what to say
A Tree | moderate | yeah, just a tree and nothing else
Carrot Cake | moderate | CARROT CAKE!!!
Choo Choo The Train | moderate | CHOO CHOO!
Dreartop | moderate | SHEEESH! HE GOT DAT DRIP THOUGH
Metal Ball | moderate | get to the top of the summit
Runner Up | moderate | on the "second" light on the tower
Aloe Vera | normal | how can it grow here? just like pin said too little sun
Blue Gelatin | normal | how creative...
Brownie | normal | how does a brownie even stick to the wall like that?
Stop Light | normal | find a stop light
Fish Cracker | intermediate | who's ready to go swimming?
Lasery | intermediate | oh maybe they shouldn't have done that
Paragraph | intermediate | removed the old description because it sucked badly
Sketchpad | intermediate | hanging off a platform as if he's some kind of god
Yoylelite | intermediate | for one of the rarest minerals in the entire universe, they don't seem like that
Beehive | hard | look inside a tree
Dragon Scale | hard | hidden in one of the hundreds of yoylebushes...
Pi | hard | well, what does pi equal?
Pill | hard | robot firey obby
Shower | hard | 
Stabby | hard | stuck on the tower..
Yoyle Soda | hard | yoyle (Hidden on the windows)
Bicycle Wheel | difficult | it's near lasery, that's all i'll tell ya.
Daffodil | difficult | look for grass
Kennel | difficult | find a way into one of the yoyle city buildings...
Piano Key | difficult | inside of fancy shop
Evil Price Tag | extreme | get on top of a roof
Ink Ball | extreme | at an area of the map where probably no one will check
Poison Marker | extreme | this isn't find the markers i swear
Robot Firey | extreme | complete an obby... or just frog jump depends if you suck at parkour
Swordy | extreme | same deal as stabby
Bolf Gall | unforgiving | this one's for vextono
Match Box | unforgiving | it's exactly where you think it is
Paint Drop | unforgiving | somewhere of its color...
Robot Leafy | unforgiving | look underneath robot firey
Squeaky Hammer | unforgiving | there has to be a way on top of the matchstick factory...
Wasabi | unforgiving | find an invisible path near lasery
Frog Four | insane | get it? because you have to "frog" jump onto a building for it? nobody clapping?
Sky | insane | THE SKY IS LITERALLY FALLING
IV Bag | dreadful | factory
Lipstick | dreadful | find a way upstairs in the stupid pets building. that's the real name lol
Mangosteen | dreadful | hidden in a blade of grass, oh no not again...
Vacuum | dreadful | cleaning on the side of a tower yeah thats completely natural
A BFDI | arduous | don't you wanna battle to win a prize?
Spongezilla | arduous | there has to be a way up that tower...
Fax Machine | strenuous | start in a bfdi's area
A BFDIA | remorseless | real
